Rank,Date,Location,Opponent,Result,Cmp,PassAtt,PassPct,PassYds,PassTD,RushAtt,RushYds,RushAvg,RushTD,Plays,Yards,YardsPerPlay,PassFirstDowns,RushFirstDowns,PenFirstDowns,TotalFirstDowns,Penalties,PenaltyYards,Fumbles,Interceptions,Turnovers,Team,game_id
1.0,2020-10-03,,Navy,W (40-7),4,9,44.4,41,0,53,369,7.0,4,62,410,6.6,3,20,2,25,3,23,0,0,0,Air Force,/cfb/boxscores/2020-10-03-air-force.html
2.0,2020-10-24,@,San Jose State,L (6-17),9,17,52.9,92,1,49,206,4.2,0,66,298,4.5,3,14,0,17,4,55,2,0,2,Air Force,/cfb/boxscores/2020-10-24-san-jose-state.html
3.0,2020-10-31,,Boise State,L (30-49),4,7,57.1,69,0,66,415,6.3,4,73,484,6.6,3,22,3,28,6,43,0,0,0,Air Force,/cfb/boxscores/2020-10-31-air-force.html
4.0,2020-11-20,,New Mexico,W (28-0),4,5,80.0,66,0,63,356,5.7,4,68,422,6.2,4,18,1,23,5,42,3,0,3,Air Force,/cfb/boxscores/2020-11-20-air-force.html
5.0,2020-12-03,@,Utah State,W (35-7),7,9,77.8,127,1,55,334,6.1,4,64,461,7.2,6,17,1,24,6,67,0,0,0,Air Force,/cfb/boxscores/2020-12-03-utah-state.html
6.0,2020-12-19,@,Army,L (7-10),6,14,42.9,107,1,26,154,5.9,0,40,261,6.5,4,7,0,11,3,15,0,3,3,Air Force,/cfb/boxscores/2020-12-19-army.html
1.0,2020-11-04,,Western Michigan,L (13-58),19,32,59.4,126,1,32,130,4.1,0,64,256,4.0,5,7,3,15,5,39,1,1,2,Akron,/cfb/boxscores/2020-11-04-akron.html
2.0,2020-11-10,@,Ohio,L (10-24),18,30,60.0,218,1,42,216,5.1,0,72,434,6.0,8,12,0,20,4,40,1,2,3,Akron,/cfb/boxscores/2020-11-10-ohio.html
3.0,2020-11-17,@,Kent State,L (35-69),9,15,60.0,154,0,41,212,5.2,4,56,366,6.5,7,11,3,21,5,35,1,1,2,Akron,/cfb/boxscores/2020-11-17-kent-state.html
4.0,2020-11-28,,Miami (OH),L (7-38),16,27,59.3,141,1,28,4,0.1,0,55,145,2.6,9,1,4,14,3,15,0,1,1,Akron,/cfb/boxscores/2020-11-28-akron.html
5.0,2020-12-05,,Bowling Green State,W (31-3),9,17,52.9,87,1,39,195,5.0,2,56,282,5.0,5,8,2,15,3,12,0,0,0,Akron,/cfb/boxscores/2020-12-05-akron.html
6.0,2020-12-12,@,Buffalo,L (7-56),12,27,44.4,112,0,30,92,3.1,1,57,204,3.6,6,3,1,10,4,49,0,1,1,Akron,/cfb/boxscores/2020-12-12-buffalo.html
1.0,2020-09-26,@,Missouri,W (38-19),23,32,71.9,303,2,36,111,3.1,3,68,414,6.1,15,7,0,22,7,49,1,0,1,Alabama,/cfb/boxscores/2020-09-26-missouri.html
2.0,2020-10-03,,Texas A&M,W (52-24),20,27,74.1,435,4,28,109,3.9,2,55,544,9.9,14,6,2,22,6,40,0,1,1,Alabama,/cfb/boxscores/2020-10-03-alabama.html
3.0,2020-10-10,@,Mississippi,W (63-48),28,32,87.5,417,2,39,306,7.8,7,71,723,10.2,22,13,2,37,8,76,1,0,1,Alabama,/cfb/boxscores/2020-10-10-mississippi.html
4.0,2020-10-17,,Georgia,W (41-24),24,33,72.7,417,4,43,147,3.4,1,76,564,7.4,19,10,4,33,6,43,0,1,1,Alabama,/cfb/boxscores/2020-10-17-alabama.html
5.0,2020-10-24,@,Tennessee,W (48-17),28,36,77.8,417,0,40,170,4.3,5,76,587,7.7,20,9,1,30,7,45,1,0,1,Alabama,/cfb/boxscores/2020-10-24-tennessee.html
6.0,2020-10-31,,Mississippi State,W (41-0),24,33,72.7,291,4,40,208,5.2,0,73,499,6.8,11,12,3,26,10,71,1,0,1,Alabama,/cfb/boxscores/2020-10-31-alabama.html
7.0,2020-11-21,,Kentucky,W (63-3),18,26,69.2,283,3,40,226,5.7,5,66,509,7.7,13,13,3,29,4,30,0,1,1,Alabama,/cfb/boxscores/2020-11-21-alabama.html
8.0,2020-11-28,,Auburn,W (42-13),18,26,69.2,302,5,27,143,5.3,1,53,445,8.4,11,8,1,20,4,30,1,0,1,Alabama,/cfb/boxscores/2020-11-28-alabama.html
9.0,2020-12-05,@,Louisiana State,W (55-17),20,29,69.0,385,4,43,265,6.2,3,72,650,9.0,14,16,2,32,4,43,1,0,1,Alabama,/cfb/boxscores/2020-12-05-louisiana-state.html
10.0,2020-12-12,@,Arkansas,W (52-3),27,33,81.8,227,0,38,216,5.7,6,71,443,6.2,13,9,2,24,2,23,1,0,1,Alabama,/cfb/boxscores/2020-12-12-arkansas.html
11.0,2020-12-19,N,Florida,W (52-46),33,43,76.7,418,5,40,187,4.7,2,83,605,7.3,21,11,1,33,8,72,0,1,1,Alabama,/cfb/boxscores/2020-12-19-florida.html
12.0,2021-01-01,N,Notre Dame*,W (31-14),25,30,83.3,297,4,24,142,5.9,0,54,439,8.1,15,8,1,24,6,59,0,0,0,Alabama,/cfb/boxscores/2021-01-01-alabama.html
13.0,2021-01-11,N,Ohio State*,W (52-24),36,45,80.0,464,5,38,157,4.1,2,83,621,7.5,22,10,1,33,6,44,1,0,1,Alabama,/cfb/boxscores/2021-01-11-alabama.html
1.0,2020-09-12,,Charlotte,W (35-20),14,21,66.7,204,1,50,308,6.2,4,71,512,7.2,10,16,3,29,7,65,2,1,3,Appalachian State,/cfb/boxscores/2020-09-12-appalachian-state.html
2.0,2020-09-19,@,Marshall,L (7-17),22,39,56.4,268,1,33,96,2.9,0,72,364,5.1,11,6,9,26,8,82,1,1,2,Appalachian State,/cfb/boxscores/2020-09-19-marshall.html
3.0,2020-09-26,,Campbell,W (52-21),12,18,66.7,131,0,60,404,6.7,7,78,535,6.9,7,22,2,31,5,45,0,0,0,Appalachian State,/cfb/boxscores/2020-09-26-appalachian-state.html
4.0,2020-10-22,,Arkansas State,W (45-17),16,23,69.6,216,4,44,305,6.9,2,67,521,7.8,11,10,1,22,8,98,1,1,2,Appalachian State,/cfb/boxscores/2020-10-22-appalachian-state.html
5.0,2020-10-31,@,Louisiana-Monroe,W (31-13),13,18,72.2,152,2,52,328,6.3,2,70,480,6.9,5,18,3,26,4,45,0,1,1,Appalachian State,/cfb/boxscores/2020-10-31-louisiana-monroe.html
6.0,2020-11-07,@,Texas State,W (38-17),18,28,64.3,168,3,43,258,6.0,1,71,426,6.0,8,14,0,22,11,94,0,0,0,Appalachian State,/cfb/boxscores/2020-11-07-texas-state.html
7.0,2020-11-14,,Georgia State,W (17-13),19,26,73.1,180,1,46,132,2.9,1,72,312,4.3,6,10,3,19,2,14,0,1,1,Appalachian State,/cfb/boxscores/2020-11-14-appalachian-state.html
8.0,2020-11-21,@,Coastal Carolina,L (23-34),17,30,56.7,211,1,46,204,4.4,1,76,415,5.5,6,16,0,22,8,51,0,3,3,Appalachian State,/cfb/boxscores/2020-11-21-coastal-carolina.html
9.0,2020-11-28,,Troy,W (47-10),22,30,73.3,279,4,38,275,7.2,1,68,554,8.1,13,12,1,26,12,90,0,0,0,Appalachian State,/cfb/boxscores/2020-11-28-appalachian-state.html
10.0,2020-12-04,,Louisiana,L (21-24),10,21,47.6,92,0,49,198,4.0,2,70,290,4.1,4,14,1,19,5,46,1,2,3,Appalachian State,/cfb/boxscores/2020-12-04-appalachian-state.html
11.0,2020-12-12,@,Georgia Southern,W (34-26),18,29,62.1,208,2,44,173,3.9,1,73,381,5.2,9,8,0,17,6,65,1,1,2,Appalachian State,/cfb/boxscores/2020-12-12-georgia-southern.html
12.0,2020-12-21,N,North Texas*,W (56-28),9,17,52.9,136,2,38,506,13.3,6,55,642,11.7,6,13,3,22,12,118,0,0,0,Appalachian State,/cfb/boxscores/2020-12-21-north-texas.html
1.0,2020-11-14,,Southern California,L (30-34),24,36,66.7,286,3,40,158,4.0,0,76,444,5.8,12,11,3,26,7,80,0,1,1,Arizona,/cfb/boxscores/2020-11-14-arizona.html
2.0,2020-11-21,@,Washington,L (27-44),27,39,69.2,259,3,26,72,2.8,1,65,331,5.1,12,6,4,22,7,40,1,0,1,Arizona,/cfb/boxscores/2020-11-21-washington.html
3.0,2020-11-28,@,UCLA,L (10-27),18,36,50.0,153,0,39,147,3.8,1,75,300,4.0,7,9,1,17,8,54,0,2,2,Arizona,/cfb/boxscores/2020-11-28-ucla.html
4.0,2020-12-05,,Colorado,L (13-24),19,32,59.4,154,0,43,268,6.2,1,75,422,5.6,8,11,4,23,6,56,0,1,1,Arizona,/cfb/boxscores/2020-12-05-arizona.html
5.0,2020-12-11,,Arizona State,L (7-70),26,46,56.5,213,0,36,137,3.8,1,82,350,4.3,5,13,0,18,6,64,4,3,7,Arizona,/cfb/boxscores/2020-12-11-arizona.html
1.0,2020-11-07,@,Southern California,L (27-28),11,23,47.8,134,1,38,258,6.8,2,61,392,6.4,5,12,3,20,4,34,3,0,3,Arizona State,/cfb/boxscores/2020-11-07-southern-california.html
2.0,2020-12-05,,UCLA,L (18-25),22,36,61.1,277,1,35,165,4.7,1,71,442,6.2,13,11,1,25,12,83,1,1,2,Arizona State,/cfb/boxscores/2020-12-05-arizona-state.html
3.0,2020-12-11,@,Arizona,W (70-7),10,13,76.9,227,2,50,259,5.2,7,63,486,7.7,7,8,2,17,6,55,0,0,0,Arizona State,/cfb/boxscores/2020-12-11-arizona.html
4.0,2020-12-19,@,Oregon State,W (46-33),8,15,53.3,139,1,42,375,8.9,6,57,514,9.0,5,12,2,19,6,46,0,0,0,Arizona State,/cfb/boxscores/2020-12-19-oregon-state.html
1.0,2020-09-26,,Georgia,L (10-37),20,39,51.3,203,1,28,77,2.8,0,67,280,4.2,8,4,3,15,10,53,0,3,3,Arkansas,/cfb/boxscores/2020-09-26-arkansas.html
2.0,2020-10-03,@,Mississippi State,W (21-14),20,28,71.4,212,2,37,63,1.7,0,65,275,4.2,10,6,1,17,5,40,2,0,2,Arkansas,/cfb/boxscores/2020-10-03-mississippi-state.html
3.0,2020-10-10,@,Auburn,L (28-30),22,30,73.3,318,4,42,119,2.8,0,72,437,6.1,15,5,2,22,6,26,0,0,0,Arkansas,/cfb/boxscores/2020-10-10-auburn.html
4.0,2020-10-17,,Mississippi,W (33-21),21,34,61.8,244,1,48,150,3.1,1,82,394,4.8,13,10,1,24,3,15,1,1,2,Arkansas,/cfb/boxscores/2020-10-17-arkansas.html
5.0,2020-10-31,@,Texas A&M,L (31-42),23,32,71.9,239,3,42,222,5.3,1,74,461,6.2,13,12,4,29,5,51,0,0,0,Arkansas,/cfb/boxscores/2020-10-31-texas-am.html
6.0,2020-11-07,,Tennessee,W (24-13),18,25,72.0,215,3,45,198,4.4,0,70,413,5.9,7,13,1,21,2,20,0,0,0,Arkansas,/cfb/boxscores/2020-11-07-arkansas.html
7.0,2020-11-14,@,Florida,L (35-63),15,19,78.9,250,2,32,208,6.5,3,51,458,9.0,8,9,1,18,9,79,1,0,1,Arkansas,/cfb/boxscores/2020-11-14-florida.html
8.0,2020-11-21,,Louisiana State,L (24-27),17,26,65.4,339,1,27,104,3.9,2,53,443,8.4,11,2,1,14,5,42,0,1,1,Arkansas,/cfb/boxscores/2020-11-21-arkansas.html
9.0,2020-12-05,@,Missouri,L (48-50),18,34,52.9,274,3,50,292,5.8,4,84,566,6.7,10,21,3,34,11,95,0,0,0,Arkansas,/cfb/boxscores/2020-12-05-missouri.html
10.0,2020-12-12,,Alabama,L (3-52),9,17,52.9,108,0,43,80,1.9,0,60,188,3.1,5,6,2,13,8,36,3,1,4,Arkansas,/cfb/boxscores/2020-12-12-arkansas.html
1.0,2020-09-05,@,Memphis,L (24-37),27,43,62.8,299,1,36,125,3.5,2,79,424,5.4,15,6,4,25,5,50,1,2,3,Arkansas State,/cfb/boxscores/2020-09-05-memphis.html
2.0,2020-09-12,@,Kansas State,W (35-31),25,38,65.8,330,5,33,159,4.8,0,71,489,6.9,15,8,3,26,4,58,1,1,2,Arkansas State,/cfb/boxscores/2020-09-12-kansas-state.html
3.0,2020-10-03,@,Coastal Carolina,L (23-52),28,44,63.6,349,3,19,36,1.9,0,63,385,6.1,11,3,1,15,4,31,1,1,2,Arkansas State,/cfb/boxscores/2020-10-03-coastal-carolina.html
4.0,2020-10-10,,Central Arkansas,W (50-27),21,40,52.5,392,6,36,181,5.0,0,76,573,7.5,16,7,2,25,8,75,1,0,1,Arkansas State,/cfb/boxscores/2020-10-10-arkansas-state.html
5.0,2020-10-15,,Georgia State,W (59-52),40,57,70.2,551,8,39,58,1.5,0,96,609,6.3,28,2,4,34,8,91,1,0,1,Arkansas State,/cfb/boxscores/2020-10-15-arkansas-state.html
6.0,2020-10-22,@,Appalachian State,L (17-45),22,42,52.4,295,0,35,73,2.1,2,77,368,4.8,14,6,4,24,10,74,0,2,2,Arkansas State,/cfb/boxscores/2020-10-22-appalachian-state.html
7.0,2020-10-31,,Troy,L (10-38),28,49,57.1,271,1,27,108,4.0,0,76,379,5.0,12,7,2,21,5,51,1,0,1,Arkansas State,/cfb/boxscores/2020-10-31-arkansas-state.html
8.0,2020-11-07,@,Louisiana,L (20-27),21,40,52.5,224,1,44,199,4.5,1,84,423,5.0,9,13,2,24,7,48,0,2,2,Arkansas State,/cfb/boxscores/2020-11-07-louisiana-lafayette.html
9.0,2020-11-21,@,Texas State,L (45-47),27,48,56.3,462,4,42,192,4.6,2,90,654,7.3,21,8,1,30,9,82,1,0,1,Arkansas State,/cfb/boxscores/2020-11-21-texas-state.html
10.0,2020-11-28,,South Alabama,L (31-38),19,30,63.3,324,4,43,170,4.0,0,73,494,6.8,15,9,1,25,7,59,0,0,0,Arkansas State,/cfb/boxscores/2020-11-28-arkansas-state.html
11.0,2020-12-05,,Louisiana-Monroe,W (48-15),17,32,53.1,511,6,32,78,2.4,0,64,589,9.2,14,4,2,20,3,12,0,1,1,Arkansas State,/cfb/boxscores/2020-12-05-arkansas-state.html
1.0,2020-09-05,,Middle Tennessee State,W (42-0),2,4,50.0,28,0,62,340,5.5,5,66,368,5.6,1,21,2,24,7,74,0,0,0,Army,/cfb/boxscores/2020-09-05-army.html
2.0,2020-09-12,,Louisiana-Monroe,W (37-7),1,5,20.0,29,0,65,436,6.7,5,70,465,6.6,1,22,1,24,4,37,1,0,1,Army,/cfb/boxscores/2020-09-12-army.html
3.0,2020-09-26,@,Cincinnati,L (10-24),9,21,42.9,94,0,43,182,4.2,0,64,276,4.3,6,9,3,18,10,87,1,1,2,Army,/cfb/boxscores/2020-09-26-cincinnati.html
4.0,2020-10-03,,Abilene Christian,W (55-23),4,7,57.1,52,1,60,441,7.4,6,67,493,7.4,1,19,4,24,4,27,0,0,0,Army,/cfb/boxscores/2020-10-03-army.html
5.0,2020-10-10,,The Citadel,W (14-9),4,10,40.0,75,1,50,153,3.1,1,60,228,3.8,4,11,1,16,6,39,0,2,2,Army,/cfb/boxscores/2020-10-10-army.html
6.0,2020-10-17,@,UTSA,W (28-16),1,3,33.3,53,0,60,305,5.1,4,63,358,5.7,1,19,4,24,5,51,1,0,1,Army,/cfb/boxscores/2020-10-17-texas-san-antonio.html
7.0,2020-10-24,,Mercer,W (49-3),2,3,66.7,63,1,63,297,4.7,5,66,360,5.5,2,19,0,21,4,29,0,0,0,Army,/cfb/boxscores/2020-10-24-army.html
8.0,2020-11-14,@,Tulane,L (12-38),5,13,38.5,33,1,57,270,4.7,1,70,303,4.3,2,15,0,17,1,5,1,2,3,Army,/cfb/boxscores/2020-11-14-tulane.html
9.0,2020-11-21,,Georgia Southern,W (28-27),1,1,100.0,25,0,73,243,3.3,4,74,268,3.6,1,18,1,20,5,54,3,0,3,Army,/cfb/boxscores/2020-11-21-army.html
10.0,2020-12-12,,Navy,W (15-0),1,1,100.0,28,0,53,134,2.5,1,54,162,3.0,1,6,1,8,4,20,0,0,0,Army,/cfb/boxscores/2020-12-12-army.html
11.0,2020-12-19,,Air Force,W (10-7),1,2,50.0,0,0,71,290,4.1,1,73,290,4.0,0,21,0,21,2,15,1,0,1,Army,/cfb/boxscores/2020-12-19-army.html
12.0,2020-12-31,N,West Virginia*,L (21-24),4,6,66.7,57,0,59,182,3.1,3,65,239,3.7,2,11,3,16,3,30,0,1,1,Army,/cfb/boxscores/2020-12-31-army.html
1.0,2020-09-26,,Kentucky,W (29-13),16,27,59.3,233,3,30,91,3.0,1,57,324,5.7,10,4,2,16,7,55,0,0,0,Auburn,/cfb/boxscores/2020-09-26-auburn.html
2.0,2020-10-03,@,Georgia,L (6-27),21,40,52.5,177,0,22,39,1.8,0,62,216,3.5,8,5,2,15,7,46,0,1,1,Auburn,/cfb/boxscores/2020-10-03-georgia.html
3.0,2020-10-10,,Arkansas,W (30-28),18,29,62.1,187,1,41,259,6.3,1,70,446,6.4,10,14,0,24,7,52,0,0,0,Auburn,/cfb/boxscores/2020-10-10-auburn.html
4.0,2020-10-17,@,South Carolina,L (22-30),24,47,51.1,272,1,36,209,5.8,1,83,481,5.8,13,13,1,27,9,89,0,3,3,Auburn,/cfb/boxscores/2020-10-17-south-carolina.html
5.0,2020-10-24,@,Mississippi,W (35-28),23,30,76.7,238,1,47,224,4.8,4,77,462,6.0,9,17,0,26,3,35,0,0,0,Auburn,/cfb/boxscores/2020-10-24-mississippi.html
6.0,2020-10-31,,Louisiana State,W (48-11),18,26,69.2,300,3,44,206,4.7,3,70,506,7.2,10,12,1,23,3,13,1,0,1,Auburn,/cfb/boxscores/2020-10-31-auburn.html
7.0,2020-11-21,,Tennessee,W (30-17),17,26,65.4,220,1,38,165,4.3,1,64,385,6.0,10,12,1,23,6,60,0,1,1,Auburn,/cfb/boxscores/2020-11-21-auburn.html
8.0,2020-11-28,@,Alabama,L (13-42),23,38,60.5,227,0,42,120,2.9,1,80,347,4.3,12,7,1,20,5,38,0,2,2,Auburn,/cfb/boxscores/2020-11-28-alabama.html
9.0,2020-12-05,,Texas A&M,L (20-31),15,24,62.5,144,0,30,196,6.5,2,54,340,6.3,7,9,0,16,1,5,0,0,0,Auburn,/cfb/boxscores/2020-12-05-auburn.html
10.0,2020-12-12,@,Mississippi State,W (24-10),15,32,46.9,125,1,36,218,6.1,1,68,343,5.0,3,13,3,19,8,80,0,0,0,Auburn,/cfb/boxscores/2020-12-12-mississippi-state.html
11.0,2021-01-01,N,Northwestern*,L (19-35),26,43,60.5,300,1,26,61,2.3,1,69,361,5.2,12,4,2,18,8,75,1,0,1,Auburn,/cfb/boxscores/2021-01-01-northwestern.html
1.0,2020-11-04,@,Miami (OH),L (31-38),19,32,59.4,309,1,38,169,4.4,3,70,478,6.8,15,9,2,26,6,63,0,1,1,Ball State,/cfb/boxscores/2020-11-04-miami-oh.html
2.0,2020-11-11,,Eastern Michigan,W (38-31),22,32,68.8,232,1,52,304,5.8,3,84,536,6.4,9,19,2,30,7,65,1,1,2,Ball State,/cfb/boxscores/2020-11-11-ball-state.html
3.0,2020-11-18,,Northern Illinois,W (31-25),17,25,68.0,214,2,44,201,4.6,1,69,415,6.0,10,12,1,23,6,50,0,1,1,Ball State,/cfb/boxscores/2020-11-18-ball-state.html
4.0,2020-11-28,@,Toledo,W (27-24),26,35,74.3,304,2,49,143,2.9,1,84,447,5.3,17,7,4,28,5,42,0,1,1,Ball State,/cfb/boxscores/2020-11-28-toledo.html
5.0,2020-12-05,@,Central Michigan,W (45-20),26,43,60.5,366,4,52,153,2.9,2,95,519,5.5,16,11,1,28,3,18,0,1,1,Ball State,/cfb/boxscores/2020-12-05-central-michigan.html
6.0,2020-12-12,,Western Michigan,W (30-27),22,33,66.7,249,3,33,103,3.1,1,66,352,5.3,9,7,1,17,8,64,0,0,0,Ball State,/cfb/boxscores/2020-12-12-ball-state.html
7.0,2020-12-18,N,Buffalo,W (38-28),20,32,62.5,273,3,47,166,3.5,1,79,439,5.6,11,10,1,22,3,25,0,1,1,Ball State,/cfb/boxscores/2020-12-18-buffalo.html
8.0,2020-12-31,N,San Jose State*,W (34-13),12,19,63.2,217,1,51,185,3.6,3,70,402,5.7,11,6,4,21,8,64,2,0,2,Ball State,/cfb/boxscores/2020-12-31-san-jose-state.html
1.0,2020-09-26,,Kansas,W (47-14),16,24,66.7,149,1,43,203,4.7,3,67,352,5.3,7,14,3,24,8,95,0,0,0,Baylor,/cfb/boxscores/2020-09-26-baylor.html
2.0,2020-10-03,@,West Virginia,L (21-27),23,38,60.5,229,3,33,27,0.8,0,71,256,3.6,6,5,4,15,12,86,0,2,2,Baylor,/cfb/boxscores/2020-10-03-west-virginia.html
3.0,2020-10-24,@,Texas,L (16-27),31,44,70.5,252,2,21,64,3.0,0,65,316,4.9,15,5,2,22,4,26,0,0,0,Baylor,/cfb/boxscores/2020-10-24-texas.html
4.0,2020-10-31,,TCU,L (23-33),17,37,45.9,203,2,33,75,2.3,1,70,278,4.0,9,3,3,15,7,58,0,1,1,Baylor,/cfb/boxscores/2020-10-31-baylor.html
5.0,2020-11-07,@,Iowa State,L (31-38),22,33,66.7,295,3,27,71,2.6,0,60,366,6.1,12,5,0,17,7,65,0,2,2,Baylor,/cfb/boxscores/2020-11-07-iowa-state.html
6.0,2020-11-14,@,Texas Tech,L (23-24),17,26,65.4,153,0,48,207,4.3,1,74,360,4.9,7,12,1,20,6,42,0,1,1,Baylor,/cfb/boxscores/2020-11-14-texas-tech.html
7.0,2020-11-28,,Kansas State,W (32-31),31,39,79.5,349,2,36,71,2.0,2,75,420,5.6,13,5,3,21,8,87,1,0,1,Baylor,/cfb/boxscores/2020-11-28-baylor.html
8.0,2020-12-05,@,Oklahoma,L (14-27),30,56,53.6,263,1,26,25,1.0,1,82,288,3.5,13,4,2,19,8,63,0,2,2,Baylor,/cfb/boxscores/2020-12-05-oklahoma.html
9.0,2020-12-12,,Oklahoma State,L (3-42),18,34,52.9,86,0,31,70,2.3,0,65,156,2.4,4,7,1,12,5,40,0,0,0,Baylor,/cfb/boxscores/2020-12-12-baylor.html
1.0,2020-10-24,,Utah State,W (42-13),22,32,68.8,279,3,35,171,4.9,3,67,450,6.7,15,10,0,25,2,14,0,0,0,Boise State,/cfb/boxscores/2020-10-24-boise-state.html
2.0,2020-10-31,@,Air Force,W (49-30),17,20,85.0,280,3,29,179,6.2,3,49,459,9.4,10,13,0,23,3,40,0,0,0,Boise State,/cfb/boxscores/2020-10-31-air-force.html
3.0,2020-11-06,,Brigham Young,L (17-51),23,38,60.5,249,2,27,61,2.3,0,65,310,4.8,10,3,1,14,4,48,1,1,2,Boise State,/cfb/boxscores/2020-11-06-boise-state.html
4.0,2020-11-12,,Colorado State,W (52-21),16,30,53.3,202,1,37,89,2.4,3,67,291,4.3,9,5,1,15,6,45,2,0,2,Boise State,/cfb/boxscores/2020-11-12-boise-state.html
5.0,2020-11-21,@,Hawaii,W (40-32),22,32,68.8,281,2,36,127,3.5,2,68,408,6.0,11,9,1,21,8,94,0,1,1,Boise State,/cfb/boxscores/2020-11-21-hawaii.html
6.0,2020-12-12,@,Wyoming,W (17-9),19,29,65.5,181,1,41,111,2.7,1,70,292,4.2,8,8,1,17,4,35,1,1,2,Boise State,/cfb/boxscores/2020-12-12-wyoming.html
7.0,2020-12-19,N,San Jose State,L (20-34),20,41,48.8,221,0,23,37,1.6,1,64,258,4.0,9,2,2,13,7,69,0,0,0,Boise State,/cfb/boxscores/2020-12-19-san-jose-state.html
1.0,2020-09-19,@,Duke,W (26-6),17,23,73.9,300,2,42,84,2.0,1,65,384,5.9,13,7,0,20,3,32,0,1,1,Boston College,/cfb/boxscores/2020-09-19-duke.html
2.0,2020-09-26,,Texas State,W (24-21),26,38,68.4,210,1,27,87,3.2,2,65,297,4.6,12,7,4,23,7,56,0,1,1,Boston College,/cfb/boxscores/2020-09-26-boston-college.html
3.0,2020-10-03,,North Carolina,L (22-26),37,56,66.1,313,2,19,40,2.1,0,75,353,4.7,14,5,3,22,12,110,0,0,0,Boston College,/cfb/boxscores/2020-10-03-boston-college.html
4.0,2020-10-10,,Pittsburgh,W (31-30),19,35,54.3,358,3,41,30,0.7,1,76,388,5.1,15,4,1,20,7,69,1,0,1,Boston College,/cfb/boxscores/2020-10-10-boston-college.html
5.0,2020-10-17,@,Virginia Tech,L (14-40),28,51,54.9,345,2,25,90,3.6,0,76,435,5.7,16,6,2,24,9,70,3,2,5,Boston College,/cfb/boxscores/2020-10-17-virginia-tech.html
6.0,2020-10-24,,Georgia Tech,W (48-27),13,21,61.9,145,2,44,264,6.0,3,65,409,6.3,7,13,3,23,10,102,0,0,0,Boston College,/cfb/boxscores/2020-10-24-boston-college.html
7.0,2020-10-31,@,Clemson,L (28-34),13,25,52.0,208,2,34,67,2.0,1,59,275,4.7,9,8,4,21,11,92,0,0,0,Boston College,/cfb/boxscores/2020-10-31-clemson.html
8.0,2020-11-07,@,Syracuse,W (16-13),20,29,69.0,208,1,47,191,4.1,0,76,399,5.3,7,13,1,21,7,65,0,0,0,Boston College,/cfb/boxscores/2020-11-07-syracuse.html
9.0,2020-11-14,,Notre Dame,L (31-45),18,40,45.0,272,2,25,85,3.4,1,65,357,5.5,13,6,3,22,5,41,1,1,2,Boston College,/cfb/boxscores/2020-11-14-boston-college.html
10.0,2020-11-28,,Louisville,W (34-27),19,26,73.1,247,2,37,188,5.1,2,63,435,6.9,9,10,2,21,3,13,1,0,1,Boston College,/cfb/boxscores/2020-11-28-boston-college.html
11.0,2020-12-05,@,Virginia,L (32-43),32,46,69.6,520,4,20,-7,-0.4,0,66,513,7.8,18,4,1,23,9,75,0,3,3,Boston College,/cfb/boxscores/2020-12-05-virginia.html
1.0,2020-11-04,@,Toledo,L (3-38),8,30,26.7,128,0,32,139,4.3,0,62,267,4.3,4,8,3,15,5,40,1,2,3,Bowling Green,/cfb/boxscores/2020-11-04-toledo.html
2.0,2020-11-10,,Kent State,L (24-62),6,20,30.0,105,0,43,260,6.0,3,63,365,5.8,4,10,2,16,12,81,1,0,1,Bowling Green,/cfb/boxscores/2020-11-10-bowling-green-state.html
3.0,2020-11-17,,Buffalo,L (17-42),17,27,63.0,219,0,44,180,4.1,2,71,399,5.6,10,11,1,22,3,15,0,1,1,Bowling Green,/cfb/boxscores/2020-11-17-bowling-green-state.html
4.0,2020-11-28,@,Ohio,L (10-52),9,21,42.9,125,1,32,181,5.7,0,53,306,5.8,5,6,1,12,7,45,0,3,3,Bowling Green,/cfb/boxscores/2020-11-28-ohio.html
5.0,2020-12-05,@,Akron,L (3-31),14,27,51.9,135,0,38,160,4.2,0,65,295,4.5,5,8,0,13,3,35,2,1,3,Bowling Green,/cfb/boxscores/2020-12-05-akron.html
1.0,2020-11-04,@,Northern Illinois,W (49-30),12,18,66.7,178,1,33,179,5.4,3,51,357,7.0,7,5,2,14,8,63,1,1,2,Buffalo,/cfb/boxscores/2020-11-04-northern-illinois.html
2.0,2020-11-10,,Miami (OH),W (42-10),17,27,63.0,353,4,45,203,4.5,2,72,556,7.7,11,9,2,22,6,52,0,0,0,Buffalo,/cfb/boxscores/2020-11-10-buffalo.html
3.0,2020-11-17,@,Bowling Green State,W (42-17),7,12,58.3,74,0,48,396,8.3,6,60,470,7.8,3,20,0,23,4,35,0,0,0,Buffalo,/cfb/boxscores/2020-11-17-bowling-green-state.html
4.0,2020-11-28,,Kent State,W (70-41),11,21,52.4,148,0,54,515,9.5,10,75,663,8.8,8,19,3,30,7,90,0,0,0,Buffalo,/cfb/boxscores/2020-11-28-buffalo.html
5.0,2020-12-12,,Akron,W (56-7),6,10,60.0,79,1,50,428,8.6,6,60,507,8.5,2,17,2,21,8,62,0,1,1,Buffalo,/cfb/boxscores/2020-12-12-buffalo.html
6.0,2020-12-18,N,Ball State,L (28-38),29,42,69.0,365,1,29,134,4.6,3,71,499,7.0,15,6,3,24,3,20,1,1,2,Buffalo,/cfb/boxscores/2020-12-18-buffalo.html
7.0,2020-12-25,N,Marshall*,W (17-10),16,27,59.3,140,0,43,155,3.6,2,70,295,4.2,6,11,4,21,6,32,0,1,1,Buffalo,/cfb/boxscores/2020-12-25-buffalo.html
1.0,2020-09-07,@,Navy,W (55-3),16,22,72.7,279,2,49,301,6.1,5,71,580,8.2,12,15,1,28,1,5,0,1,1,BYU,/cfb/boxscores/2020-09-07-navy.html
2.0,2020-09-26,,Troy,W (48-7),28,34,82.4,472,2,46,194,4.2,4,80,666,8.3,17,13,2,32,2,15,1,0,1,BYU,/cfb/boxscores/2020-09-26-brigham-young.html
3.0,2020-10-02,,Louisiana Tech,W (45-14),24,26,92.3,325,2,38,188,4.9,4,64,513,8.0,14,11,1,26,5,50,0,0,0,BYU,/cfb/boxscores/2020-10-02-brigham-young.html
4.0,2020-10-10,,UTSA,W (27-20),22,30,73.3,292,2,38,178,4.7,2,68,470,6.9,10,9,3,22,7,55,1,0,1,BYU,/cfb/boxscores/2020-10-10-brigham-young.html
5.0,2020-10-16,@,Houston,W (43-26),25,35,71.4,400,4,24,78,3.3,2,59,478,8.1,16,4,3,23,9,73,0,0,0,BYU,/cfb/boxscores/2020-10-16-houston.html
6.0,2020-10-24,,Texas State,W (52-14),25,36,69.4,352,4,39,247,6.3,2,75,599,8.0,17,11,2,30,3,33,1,1,2,BYU,/cfb/boxscores/2020-10-24-brigham-young.html
7.0,2020-10-31,,Western Kentucky,W (41-10),21,37,56.8,244,3,32,166,5.2,2,69,410,5.9,10,10,5,25,3,35,0,1,1,BYU,/cfb/boxscores/2020-10-31-brigham-young.html
8.0,2020-11-06,@,Boise State,W (51-17),22,28,78.6,360,3,37,213,5.8,4,65,573,8.8,14,9,2,25,4,33,0,0,0,BYU,/cfb/boxscores/2020-11-06-boise-state.html
9.0,2020-11-21,,North Alabama,W (66-14),18,26,69.2,277,5,33,278,8.4,4,59,555,9.4,11,12,2,25,5,43,0,0,0,BYU,/cfb/boxscores/2020-11-21-brigham-young.html
10.0,2020-12-05,@,Coastal Carolina,L (17-22),19,32,59.4,240,1,26,165,6.3,1,58,405,7.0,12,8,1,21,3,20,1,1,2,BYU,/cfb/boxscores/2020-12-05-coastal-carolina.html
11.0,2020-12-12,,San Diego State,W (28-14),26,35,74.3,303,3,19,83,4.4,0,54,386,7.1,12,4,0,16,5,25,1,0,1,BYU,/cfb/boxscores/2020-12-12-brigham-young.html
12.0,2020-12-22,N,Central Florida*,W (49-23),27,35,77.1,441,3,38,214,5.6,4,73,655,9.0,19,13,2,34,5,55,0,0,0,BYU,/cfb/boxscores/2020-12-22-brigham-young.html
1.0,2020-11-15,@,UCLA,L (10-34),18,34,52.9,122,0,28,54,1.9,1,62,176,2.8,5,4,2,11,5,33,0,1,1,California,/cfb/boxscores/2020-11-15-ucla.html
2.0,2020-11-21,@,Oregon State,L (27-31),28,42,66.7,315,3,38,118,3.1,0,80,433,5.4,12,7,5,24,7,59,0,2,2,California,/cfb/boxscores/2020-11-21-oregon-state.html
3.0,2020-11-27,,Stanford,L (23-24),19,30,63.3,151,2,35,241,6.9,1,65,392,6.0,10,8,2,20,1,10,2,0,2,California,/cfb/boxscores/2020-11-27-california.html
4.0,2020-12-05,,Oregon,W (21-17),20,32,62.5,183,1,47,88,1.9,2,79,271,3.4,10,5,3,18,4,33,0,0,0,California,/cfb/boxscores/2020-12-05-california.html
1.0,2020-11-04,,Ohio,W (30-27),23,41,56.1,243,1,47,184,3.9,3,88,427,4.9,13,10,1,24,6,64,0,0,0,Central Michigan,/cfb/boxscores/2020-11-04-central-michigan.html
2.0,2020-11-11,@,Northern Illinois,W (40-10),13,20,65.0,196,2,42,237,5.6,3,62,433,7.0,5,11,0,16,6,75,0,1,1,Central Michigan,/cfb/boxscores/2020-11-11-northern-illinois.html
3.0,2020-11-18,,Western Michigan,L (44-52),14,21,66.7,187,1,36,219,6.1,5,57,406,7.1,8,8,1,17,8,56,0,0,0,Central Michigan,/cfb/boxscores/2020-11-18-central-michigan.html
4.0,2020-11-27,@,Eastern Michigan,W (31-23),24,36,66.7,235,0,57,318,5.6,3,93,553,5.9,8,19,1,28,7,64,2,1,3,Central Michigan,/cfb/boxscores/2020-11-27-eastern-michigan.html
5.0,2020-12-05,,Ball State,L (20-45),20,30,66.7,188,2,36,154,4.3,1,66,342,5.2,8,9,0,17,6,58,2,2,4,Central Michigan,/cfb/boxscores/2020-12-05-central-michigan.html
6.0,2020-12-12,@,Toledo,L (23-24),12,24,50.0,165,1,42,197,4.7,1,66,362,5.5,7,8,0,15,4,40,1,0,1,Central Michigan,/cfb/boxscores/2020-12-12-toledo.html
1.0,2020-09-12,@,Appalachian State,L (20-35),11,30,36.7,140,0,30,146,4.9,1,60,286,4.8,7,6,3,16,5,63,0,2,2,Charlotte,/cfb/boxscores/2020-09-12-appalachian-state.html
2.0,2020-10-03,@,Florida Atlantic,L (17-21),24,32,75.0,314,1,41,82,2.0,1,73,396,5.4,13,8,1,22,3,27,1,0,1,Charlotte,/cfb/boxscores/2020-10-03-florida-atlantic.html
3.0,2020-10-10,@,North Texas,W (49-21),16,23,69.6,308,3,47,291,6.2,4,70,599,8.6,11,11,2,24,12,75,0,0,0,Charlotte,/cfb/boxscores/2020-10-10-north-texas.html
4.0,2020-10-24,,UTEP,W (38-28),14,23,60.9,185,2,35,144,4.1,3,58,329,5.7,8,9,0,17,11,122,0,0,0,Charlotte,/cfb/boxscores/2020-10-24-charlotte.html
5.0,2020-10-31,@,Duke,L (19-53),18,36,50.0,171,1,51,177,3.5,2,87,348,4.0,10,9,3,22,5,35,2,0,2,Charlotte,/cfb/boxscores/2020-10-31-duke.html
6.0,2020-12-06,,Western Kentucky,L (19-37),15,35,42.9,219,3,33,89,2.7,0,68,308,4.5,10,8,0,18,6,48,1,0,1,Charlotte,/cfb/boxscores/2020-12-06-charlotte.html
1.0,2020-09-19,,Austin Peay,W (55-20),17,26,65.4,249,3,41,276,6.7,5,67,525,7.8,10,13,1,24,5,45,1,0,1,Cincinnati,/cfb/boxscores/2020-09-19-cincinnati.html
2.0,2020-09-26,,Army,W (24-10),19,34,55.9,262,2,35,69,2.0,1,69,331,4.8,9,4,1,14,7,79,1,1,2,Cincinnati,/cfb/boxscores/2020-09-26-cincinnati.html
3.0,2020-10-03,,South Florida,W (28-7),16,26,61.5,143,2,45,189,4.2,1,71,332,4.7,9,12,1,22,7,52,1,3,4,Cincinnati,/cfb/boxscores/2020-10-03-cincinnati.html
4.0,2020-10-24,@,Southern Methodist,W (42-13),13,21,61.9,126,1,35,313,8.9,5,56,439,7.8,7,10,0,17,12,126,2,0,2,Cincinnati,/cfb/boxscores/2020-10-24-southern-methodist.html
5.0,2020-10-31,,Memphis,W (49-10),21,26,80.8,271,3,41,242,5.9,4,67,513,7.7,15,11,2,28,5,40,0,1,1,Cincinnati,/cfb/boxscores/2020-10-31-cincinnati.html
6.0,2020-11-07,,Houston,W (38-10),20,30,66.7,168,1,39,342,8.8,4,69,510,7.4,8,15,1,24,5,35,0,1,1,Cincinnati,/cfb/boxscores/2020-11-07-cincinnati.html
7.0,2020-11-13,,East Carolina,W (55-17),27,34,79.4,354,3,32,299,9.3,4,66,653,9.9,18,11,0,29,13,159,1,0,1,Cincinnati,/cfb/boxscores/2020-11-13-cincinnati.html
8.0,2020-11-21,@,Central Florida,W (36-33),21,32,65.6,338,2,48,144,3.0,2,80,482,6.0,16,10,2,28,11,86,1,0,1,Cincinnati,/cfb/boxscores/2020-11-21-central-florida.html
9.0,2020-12-19,,Tulsa,W (27-24),19,29,65.5,269,1,38,151,4.0,2,67,420,6.3,11,5,1,17,12,66,2,0,2,Cincinnati,/cfb/boxscores/2020-12-19-cincinnati.html
10.0,2021-01-01,N,Georgia*,L (21-24),24,37,64.9,206,2,27,99,3.7,1,64,305,4.8,9,6,1,16,11,80,1,0,1,Cincinnati,/cfb/boxscores/2021-01-01-cincinnati.html
1.0,2020-09-12,@,Wake Forest,W (37-13),26,36,72.2,376,1,46,185,4.0,3,82,561,6.8,16,11,0,27,5,55,0,1,1,Clemson,/cfb/boxscores/2020-09-12-wake-forest.html
2.0,2020-09-19,,The Citadel,W (49-0),19,27,70.4,243,3,33,162,4.9,3,60,405,6.8,10,5,1,16,5,35,1,0,1,Clemson,/cfb/boxscores/2020-09-19-clemson.html
3.0,2020-10-03,,Virginia,W (41-23),26,39,66.7,329,3,31,137,4.4,2,70,466,6.7,14,7,1,22,8,65,0,0,0,Clemson,/cfb/boxscores/2020-10-03-clemson.html
4.0,2020-10-10,,Miami (FL),W (42-17),29,44,65.9,292,3,44,258,5.9,3,88,550,6.3,16,12,6,34,8,85,1,0,1,Clemson,/cfb/boxscores/2020-10-10-clemson.html
5.0,2020-10-17,@,Georgia Tech,W (73-7),33,49,67.3,500,7,39,171,4.4,3,88,671,7.6,20,8,1,29,2,20,1,1,2,Clemson,/cfb/boxscores/2020-10-17-georgia-tech.html
6.0,2020-10-24,,Syracuse,W (47-21),29,47,61.7,308,2,37,147,4.0,3,84,455,5.4,16,10,1,27,4,25,0,1,1,Clemson,/cfb/boxscores/2020-10-24-clemson.html
7.0,2020-10-31,,Boston College,W (34-28),30,43,69.8,342,2,31,106,3.4,2,74,448,6.1,16,7,3,26,9,82,1,0,1,Clemson,/cfb/boxscores/2020-10-31-clemson.html
8.0,2020-11-07,@,Notre Dame,L (40-47),29,44,65.9,439,2,33,34,1.0,2,77,473,6.1,16,4,2,22,4,46,3,0,3,Clemson,/cfb/boxscores/2020-11-07-notre-dame.html
9.0,2020-11-28,,Pittsburgh,W (52-17),35,52,67.3,436,3,38,145,3.8,4,90,581,6.5,15,10,2,27,8,55,1,0,1,Clemson,/cfb/boxscores/2020-11-28-clemson.html
10.0,2020-12-05,@,Virginia Tech,W (45-10),12,22,54.5,195,1,30,238,7.9,4,52,433,8.3,7,12,0,19,4,30,0,1,1,Clemson,/cfb/boxscores/2020-12-05-virginia-tech.html
11.0,2020-12-19,N,Notre Dame,W (34-10),25,39,64.1,322,2,27,219,8.1,2,66,541,8.2,12,10,1,23,5,60,0,1,1,Clemson,/cfb/boxscores/2020-12-19-notre-dame.html
12.0,2021-01-01,N,Ohio State*,L (28-49),33,48,68.8,400,2,22,44,2.0,2,70,444,6.3,17,4,2,23,3,20,1,1,2,Clemson,/cfb/boxscores/2021-01-01-clemson.html
1.0,2020-09-12,@,Kansas,W (38-23),11,18,61.1,133,3,42,185,4.4,2,60,318,5.3,4,13,2,19,4,48,0,0,0,Coastal Carolina,/cfb/boxscores/2020-09-12-kansas.html
2.0,2020-09-18,,Campbell,W (43-21),11,17,64.7,273,2,36,193,5.4,4,53,466,8.8,10,10,1,21,4,49,0,0,0,Coastal Carolina,/cfb/boxscores/2020-09-18-coastal-carolina.html
3.0,2020-10-03,,Arkansas State,W (52-23),20,29,69.0,322,4,51,217,4.3,3,80,539,6.7,13,12,0,25,3,31,2,1,3,Coastal Carolina,/cfb/boxscores/2020-10-03-coastal-carolina.html
4.0,2020-10-14,@,Louisiana,W (30-27),17,24,70.8,202,2,48,212,4.4,2,72,414,5.8,10,12,1,23,3,25,0,0,0,Coastal Carolina,/cfb/boxscores/2020-10-14-louisiana-lafayette.html
5.0,2020-10-24,,Georgia Southern,W (28-14),15,28,53.6,252,3,41,130,3.2,1,69,382,5.5,9,10,1,20,5,49,0,2,2,Coastal Carolina,/cfb/boxscores/2020-10-24-coastal-carolina.html
6.0,2020-10-31,@,Georgia State,W (51-0),21,29,72.4,280,4,47,250,5.3,3,76,530,7.0,14,15,1,30,1,6,1,0,1,Coastal Carolina,/cfb/boxscores/2020-10-31-georgia-state.html
7.0,2020-11-07,,South Alabama,W (23-6),17,25,68.0,209,1,33,236,7.2,1,58,445,7.7,10,8,0,18,2,20,2,0,2,Coastal Carolina,/cfb/boxscores/2020-11-07-coastal-carolina.html
8.0,2020-11-21,,Appalachian State,W (34-23),12,21,57.1,200,2,34,169,5.0,2,55,369,6.7,7,8,1,16,1,5,1,0,1,Coastal Carolina,/cfb/boxscores/2020-11-21-coastal-carolina.html
9.0,2020-11-28,@,Texas State,W (49-14),12,20,60.0,166,2,56,406,7.3,5,76,572,7.5,9,21,2,32,4,25,0,0,0,Coastal Carolina,/cfb/boxscores/2020-11-28-texas-state.html
10.0,2020-12-05,,Brigham Young,W (22-17),10,15,66.7,85,0,54,281,5.2,3,69,366,5.3,4,18,0,22,4,40,1,0,1,Coastal Carolina,/cfb/boxscores/2020-12-05-coastal-carolina.html
11.0,2020-12-12,@,Troy,W (42-38),24,29,82.8,338,3,43,176,4.1,3,72,514,7.1,17,9,3,29,6,70,0,1,1,Coastal Carolina,/cfb/boxscores/2020-12-12-troy.html
12.0,2020-12-26,N,Liberty*,L (34-37),21,32,65.6,318,3,33,165,5.0,1,65,483,7.4,14,7,3,24,7,60,0,1,1,Coastal Carolina,/cfb/boxscores/2020-12-26-coastal-carolina.html
1.0,2020-11-07,,UCLA,W (48-42),22,33,66.7,261,1,59,264,4.5,5,92,525,5.7,12,13,1,26,9,90,0,0,0,Colorado,/cfb/boxscores/2020-11-07-colorado.html
2.0,2020-11-14,@,Stanford,W (35-32),15,24,62.5,255,2,45,177,3.9,3,69,432,6.3,10,11,1,22,6,61,0,1,1,Colorado,/cfb/boxscores/2020-11-14-stanford.html
3.0,2020-11-28,,San Diego State,W (20-10),17,29,58.6,138,1,53,134,2.5,1,82,272,3.3,7,8,4,19,3,40,0,1,1,Colorado,/cfb/boxscores/2020-11-28-colorado.html
4.0,2020-12-05,@,Arizona,W (24-13),12,20,60.0,92,0,46,407,8.8,3,66,499,7.6,6,10,2,18,5,47,1,2,3,Colorado,/cfb/boxscores/2020-12-05-arizona.html
5.0,2020-12-12,,Utah,L (21-38),18,39,46.2,267,2,27,110,4.1,0,66,377,5.7,10,5,0,15,4,35,2,1,3,Colorado,/cfb/boxscores/2020-12-12-colorado.html
6.0,2020-12-29,N,Texas*,L (23-55),14,33,42.4,196,0,46,182,4.0,3,79,378,4.8,8,8,4,20,7,65,1,2,3,Colorado,/cfb/boxscores/2020-12-29-colorado.html
1.0,2020-10-29,@,Fresno State,L (17-38),17,33,51.5,223,1,40,149,3.7,1,73,372,5.1,11,9,1,21,7,61,1,0,1,Colorado State,/cfb/boxscores/2020-10-29-fresno-state.html
2.0,2020-11-05,,Wyoming,W (34-24),18,26,69.2,255,2,37,87,2.4,1,63,342,5.4,9,6,3,18,6,45,0,0,0,Colorado State,/cfb/boxscores/2020-11-05-colorado-state.html
3.0,2020-11-12,@,Boise State,L (21-52),11,29,37.9,176,1,41,139,3.4,2,70,315,4.5,8,7,0,15,6,48,0,1,1,Colorado State,/cfb/boxscores/2020-11-12-boise-state.html
4.0,2020-12-05,@,San Diego State,L (17-29),13,28,46.4,144,0,38,121,3.2,2,66,265,4.0,7,7,1,15,5,36,0,2,2,Colorado State,/cfb/boxscores/2020-12-05-san-diego-state.html
1.0,2020-09-12,@,Notre Dame,L (13-27),20,37,54.1,259,0,30,79,2.6,1,67,338,5.0,13,4,2,19,4,31,2,0,2,Duke,/cfb/boxscores/2020-09-12-notre-dame.html
2.0,2020-09-19,,Boston College,L (6-26),23,42,54.8,217,0,29,134,4.6,1,71,351,4.9,11,7,1,19,4,56,3,2,5,Duke,/cfb/boxscores/2020-09-19-duke.html
3.0,2020-09-26,@,Virginia,L (20-38),18,40,45.0,286,2,38,56,1.5,0,78,342,4.4,12,4,1,17,3,25,2,5,7,Duke,/cfb/boxscores/2020-09-26-virginia.html
4.0,2020-10-03,,Virginia Tech,L (31-38),23,40,57.5,279,1,37,139,3.8,2,77,418,5.4,13,6,0,19,8,76,0,1,1,Duke,/cfb/boxscores/2020-10-03-duke.html
5.0,2020-10-10,@,Syracuse,W (38-24),23,39,59.0,282,2,63,363,5.8,2,102,645,6.3,16,17,3,36,2,25,3,1,4,Duke,/cfb/boxscores/2020-10-10-syracuse.html
6.0,2020-10-17,@,North Carolina State,L (20-31),24,40,60.0,190,1,41,129,3.1,0,81,319,3.9,10,9,5,24,5,55,0,3,3,Duke,/cfb/boxscores/2020-10-17-north-carolina-state.html
7.0,2020-10-31,,Charlotte,W (53-19),10,17,58.8,127,1,34,274,8.1,6,51,401,7.9,8,7,1,16,6,35,0,1,1,Duke,/cfb/boxscores/2020-10-31-duke.html
8.0,2020-11-07,,North Carolina,L (24-56),18,32,56.3,226,0,42,185,4.4,3,74,411,5.6,11,10,5,26,7,63,1,1,2,Duke,/cfb/boxscores/2020-11-07-duke.html
9.0,2020-11-28,@,Georgia Tech,L (33-56),23,47,48.9,314,2,40,68,1.7,1,87,382,4.4,14,6,3,23,8,63,4,1,5,Duke,/cfb/boxscores/2020-11-28-georgia-tech.html
10.0,2020-12-05,,Miami (FL),L (0-48),25,31,80.6,121,0,33,56,1.7,0,64,177,2.8,5,8,1,14,6,55,4,1,5,Duke,/cfb/boxscores/2020-12-05-duke.html
11.0,2020-12-12,@,Florida State,L (35-56),13,26,50.0,148,2,51,245,4.8,3,77,393,5.1,6,15,4,25,9,70,1,3,4,Duke,/cfb/boxscores/2020-12-12-florida-state.html
1.0,2020-09-26,,Central Florida,L (28-51),14,29,48.3,215,3,54,244,4.5,1,83,459,5.5,11,11,3,25,11,105,3,1,4,East Carolina,/cfb/boxscores/2020-09-26-east-carolina.html
2.0,2020-10-03,@,Georgia State,L (29-49),29,52,55.8,242,0,26,50,1.9,1,78,292,3.7,11,4,4,19,11,97,0,3,3,East Carolina,/cfb/boxscores/2020-10-03-georgia-state.html
3.0,2020-10-10,@,South Florida,W (44-24),17,26,65.4,222,3,47,210,4.5,2,73,432,5.9,11,9,1,21,3,45,0,0,0,East Carolina,/cfb/boxscores/2020-10-10-south-florida.html
4.0,2020-10-17,,Navy,L (23-27),10,20,50.0,104,0,45,268,6.0,2,65,372,5.7,5,13,1,19,3,20,2,0,2,East Carolina,/cfb/boxscores/2020-10-17-east-carolina.html
5.0,2020-10-30,@,Tulsa,L (30-34),38,50,76.0,330,3,28,126,4.5,0,78,456,5.8,14,7,6,27,13,105,2,1,3,East Carolina,/cfb/boxscores/2020-10-30-tulsa.html
6.0,2020-11-07,,Tulane,L (21-38),27,43,62.8,351,3,29,35,1.2,0,72,386,5.4,12,5,3,20,4,23,1,0,1,East Carolina,/cfb/boxscores/2020-11-07-east-carolina.html
7.0,2020-11-13,@,Cincinnati,L (17-55),9,21,42.9,87,0,50,206,4.1,2,71,293,4.1,5,13,5,23,4,45,1,3,4,East Carolina,/cfb/boxscores/2020-11-13-cincinnati.html
8.0,2020-11-21,@,Temple,W (28-3),11,22,50.0,182,2,40,265,6.6,1,62,447,7.2,7,9,0,16,1,12,1,1,2,East Carolina,/cfb/boxscores/2020-11-21-temple.html
9.0,2020-11-28,,Southern Methodist,W (52-38),21,30,70.0,333,5,43,160,3.7,2,73,493,6.8,15,9,4,28,7,72,2,0,2,East Carolina,/cfb/boxscores/2020-11-28-east-carolina.html
1.0,2020-11-04,@,Kent State,L (23-27),21,35,60.0,241,2,32,61,1.9,1,67,302,4.5,12,5,3,20,2,30,0,2,2,Eastern Michigan,/cfb/boxscores/2020-11-04-kent-state.html
2.0,2020-11-11,@,Ball State,L (31-38),17,29,58.6,255,1,41,258,6.3,3,70,513,7.3,12,10,0,22,5,48,1,0,1,Eastern Michigan,/cfb/boxscores/2020-11-11-ball-state.html
3.0,2020-11-18,,Toledo,L (28-45),25,39,64.1,244,4,31,34,1.1,0,70,278,4.0,10,4,4,18,10,89,2,1,3,Eastern Michigan,/cfb/boxscores/2020-11-18-eastern-michigan.html
4.0,2020-11-27,,Central Michigan,L (23-31),23,37,62.2,365,0,31,74,2.4,2,68,439,6.5,15,6,1,22,2,15,2,3,5,Eastern Michigan,/cfb/boxscores/2020-11-27-eastern-michigan.html
5.0,2020-12-05,@,Western Michigan,W (53-42),19,30,63.3,315,3,46,218,4.7,3,76,533,7.0,13,9,2,24,5,40,0,0,0,Eastern Michigan,/cfb/boxscores/2020-12-05-western-michigan.html
6.0,2020-12-12,,Northern Illinois,W (41-33),21,29,72.4,242,2,38,131,3.4,2,67,373,5.6,13,10,2,25,5,41,1,0,1,Eastern Michigan,/cfb/boxscores/2020-12-12-eastern-michigan.html
1.0,2020-09-26,@,Mississippi,W (51-35),31,45,68.9,446,6,29,196,6.8,0,74,642,8.7,21,9,2,32,4,40,0,1,1,Florida,/cfb/boxscores/2020-09-26-mississippi.html
2.0,2020-10-03,,South Carolina,W (38-24),21,29,72.4,268,4,24,80,3.3,1,53,348,6.6,11,5,2,18,4,44,1,1,2,Florida,/cfb/boxscores/2020-10-03-florida.html
3.0,2020-10-10,@,Texas A&M,L (38-41),23,32,71.9,312,4,24,90,3.8,1,56,402,7.2,14,5,3,22,5,32,1,0,1,Florida,/cfb/boxscores/2020-10-10-texas-am.html
4.0,2020-10-31,,Missouri,W (41-17),21,36,58.3,345,4,35,169,4.8,1,71,514,7.2,14,9,2,25,8,65,1,1,2,Florida,/cfb/boxscores/2020-10-31-florida.html
5.0,2020-11-07,N,Georgia,W (44-28),30,43,69.8,474,4,37,97,2.6,1,80,571,7.1,22,5,2,29,3,15,0,1,1,Florida,/cfb/boxscores/2020-11-07-georgia.html
6.0,2020-11-14,,Arkansas,W (63-35),27,38,71.1,385,7,45,208,4.6,1,83,593,7.1,18,15,3,36,3,35,0,1,1,Florida,/cfb/boxscores/2020-11-14-florida.html
7.0,2020-11-21,@,Vanderbilt,W (38-17),27,36,75.0,413,4,40,173,4.3,1,76,586,7.7,19,10,0,29,6,46,1,0,1,Florida,/cfb/boxscores/2020-11-21-vanderbilt.html
8.0,2020-11-28,,Kentucky,W (34-10),26,32,81.3,314,3,25,104,4.2,0,57,418,7.3,12,5,4,21,5,40,2,0,2,Florida,/cfb/boxscores/2020-11-28-florida.html
9.0,2020-12-05,@,Tennessee,W (31-19),35,49,71.4,433,4,17,19,1.1,0,66,452,6.8,21,1,2,24,8,85,0,0,0,Florida,/cfb/boxscores/2020-12-05-tennessee.html
10.0,2020-12-12,,Louisiana State,L (34-37),29,48,60.4,474,2,26,135,5.2,2,74,609,8.2,19,5,2,26,4,29,1,2,3,Florida,/cfb/boxscores/2020-12-12-florida.html
11.0,2020-12-19,N,Alabama,L (46-52),26,40,65.0,408,3,26,54,2.1,3,66,462,7.0,16,6,4,26,6,50,2,0,2,Florida,/cfb/boxscores/2020-12-19-florida.html
12.0,2020-12-30,N,Oklahoma*,L (20-55),25,45,55.6,271,1,39,250,6.4,1,84,521,6.2,15,12,1,28,8,61,0,3,3,Florida,/cfb/boxscores/2020-12-30-oklahoma.html
1.0,2020-10-03,,Charlotte,W (21-17),11,22,50.0,98,2,33,217,6.6,1,55,315,5.7,5,9,1,15,3,19,0,0,0,Florida Atlantic,/cfb/boxscores/2020-10-03-florida-atlantic.html
2.0,2020-10-24,@,Marshall,L (9-20),18,30,60.0,148,0,37,86,2.3,1,67,234,3.5,9,7,1,17,11,126,0,1,1,Florida Atlantic,/cfb/boxscores/2020-10-24-marshall.html
3.0,2020-10-31,,UTSA,W (24-3),11,20,55.0,136,1,50,196,3.9,2,70,332,4.7,6,11,2,19,6,40,0,0,0,Florida Atlantic,/cfb/boxscores/2020-10-31-florida-atlantic.html
4.0,2020-11-07,,Western Kentucky,W (10-6),7,17,41.2,108,0,45,165,3.7,1,62,273,4.4,6,11,1,18,2,25,0,1,1,Florida Atlantic,/cfb/boxscores/2020-11-07-florida-atlantic.html
5.0,2020-11-13,@,Florida International,W (38-19),10,16,62.5,80,2,52,381,7.3,3,68,461,6.8,5,16,1,22,2,10,1,0,1,Florida Atlantic,/cfb/boxscores/2020-11-13-florida-international.html
6.0,2020-11-20,,Massachusetts,W (24-2),15,30,50.0,228,1,44,140,3.2,2,74,368,5.0,8,7,1,16,4,20,1,0,1,Florida Atlantic,/cfb/boxscores/2020-11-20-florida-atlantic.html
7.0,2020-12-05,@,Georgia Southern,L (3-20),14,28,50.0,189,0,29,133,4.6,0,57,322,5.6,10,5,1,16,5,30,2,2,4,Florida Atlantic,/cfb/boxscores/2020-12-05-georgia-southern.html
8.0,2020-12-10,@,Southern Mississippi,L (31-45),17,34,50.0,162,1,34,164,4.8,2,68,326,4.8,9,7,3,19,7,60,0,1,1,Florida Atlantic,/cfb/boxscores/2020-12-10-southern-mississippi.html
9.0,2020-12-23,N,Memphis*,L (10-25),19,35,54.3,151,1,39,139,3.6,0,74,290,3.9,7,11,1,19,2,20,1,1,2,Florida Atlantic,/cfb/boxscores/2020-12-23-florida-atlantic.html
1.0,2020-09-26,@,Liberty,L (34-36),11,20,55.0,136,2,31,188,6.1,2,51,324,6.4,7,7,2,16,15,127,0,0,0,Florida International,/cfb/boxscores/2020-09-26-liberty.html
2.0,2020-10-10,,Middle Tennessee State,L (28-31),8,21,38.1,58,0,44,270,6.1,4,65,328,5.0,4,10,1,15,4,25,0,1,1,Florida International,/cfb/boxscores/2020-10-10-florida-international.html
3.0,2020-10-23,,Jacksonville State,L (10-19),7,19,36.8,84,1,24,72,3.0,0,43,156,3.6,3,3,0,6,4,26,1,0,1,Florida International,/cfb/boxscores/2020-10-23-florida-international.html
4.0,2020-11-13,,Florida Atlantic,L (19-38),18,33,54.5,192,1,33,156,4.7,1,66,348,5.3,9,6,0,15,7,47,0,0,0,Florida International,/cfb/boxscores/2020-11-13-florida-international.html
5.0,2020-11-21,@,Western Kentucky,L (21-38),14,37,37.8,147,1,44,116,2.6,1,81,263,3.2,7,8,2,17,2,15,1,1,2,Florida International,/cfb/boxscores/2020-11-21-western-kentucky.html
1.0,2020-09-12,,Georgia Tech,L (13-16),23,45,51.1,198,1,35,109,3.1,0,80,307,3.8,11,10,0,21,8,55,2,1,3,Florida State,/cfb/boxscores/2020-09-12-florida-state.html
2.0,2020-09-26,@,Miami (FL),L (10-52),22,37,59.5,179,1,36,151,4.2,0,73,330,4.5,11,10,2,23,12,113,0,3,3,Florida State,/cfb/boxscores/2020-09-26-miami-fl.html
3.0,2020-10-03,,Jacksonville State,W (41-24),20,29,69.0,268,1,53,263,5.0,5,82,531,6.5,10,18,3,31,10,100,0,1,1,Florida State,/cfb/boxscores/2020-10-03-florida-state.html
4.0,2020-10-10,@,Notre Dame,L (26-42),17,31,54.8,252,1,40,153,3.8,2,71,405,5.7,11,6,1,18,7,59,0,1,1,Florida State,/cfb/boxscores/2020-10-10-notre-dame.html
5.0,2020-10-17,,North Carolina,W (31-28),8,19,42.1,191,1,36,241,6.7,2,55,432,7.9,5,11,0,16,12,89,0,1,1,Florida State,/cfb/boxscores/2020-10-17-florida-state.html
6.0,2020-10-24,@,Louisville,L (16-48),14,41,34.1,141,1,40,265,6.6,1,81,406,5.0,12,19,6,19,11,104,0,1,1,Florida State,/cfb/boxscores/2020-10-24-louisville.html
7.0,2020-11-07,,Pittsburgh,L (17-41),23,41,56.1,144,0,35,146,4.2,2,76,290,3.8,5,8,4,17,8,57,0,3,3,Florida State,/cfb/boxscores/2020-11-07-florida-state.html
8.0,2020-11-14,@,North Carolina State,L (22-38),18,28,64.3,200,2,34,147,4.3,1,62,347,5.6,6,8,2,16,6,66,1,1,2,Florida State,/cfb/boxscores/2020-11-14-north-carolina-state.html
9.0,2020-12-12,,Duke,W (56-35),14,21,66.7,198,2,40,343,8.6,6,61,541,8.9,6,16,2,24,6,57,1,1,2,Florida State,/cfb/boxscores/2020-12-12-florida-state.html
1.0,2020-10-24,,Hawaii,L (19-34),17,31,54.8,289,1,37,120,3.2,1,68,409,6.0,11,9,2,22,7,50,1,3,4,Fresno State,/cfb/boxscores/2020-10-24-fresno-state.html
2.0,2020-10-29,,Colorado State,W (38-17),25,36,69.4,348,3,43,84,2.0,2,79,432,5.5,16,6,2,24,5,50,0,0,0,Fresno State,/cfb/boxscores/2020-10-29-fresno-state.html
3.0,2020-11-07,@,Nevada-Las Vegas,W (40-27),20,35,57.1,244,1,36,243,6.8,4,71,487,6.9,8,13,1,22,8,65,1,0,1,Fresno State,/cfb/boxscores/2020-11-07-nevada-las-vegas.html
4.0,2020-11-14,@,Utah State,W (35-16),29,38,76.3,422,4,37,119,3.2,1,75,541,7.2,18,7,0,25,5,39,1,1,2,Fresno State,/cfb/boxscores/2020-11-14-utah-state.html
5.0,2020-12-05,@,Nevada,L (26-37),41,65,63.1,485,2,40,114,2.9,2,105,599,5.7,23,7,0,30,4,33,2,0,2,Fresno State,/cfb/boxscores/2020-12-05-nevada.html
6.0,2020-12-12,N,New Mexico,L (39-49),26,43,60.5,350,3,23,58,2.5,2,66,408,6.2,15,4,4,23,4,50,0,1,1,Fresno State,/cfb/boxscores/2020-12-12-new-mexico.html
1.0,2020-09-26,@,Arkansas,W (37-10),28,47,59.6,266,2,42,121,2.9,1,89,387,4.3,10,8,1,19,12,108,1,1,2,Georgia,/cfb/boxscores/2020-09-26-arkansas.html
2.0,2020-10-03,,Auburn,W (27-6),17,28,60.7,240,1,45,202,4.5,2,73,442,6.1,12,13,0,25,8,59,0,0,0,Georgia,/cfb/boxscores/2020-10-03-georgia.html
3.0,2020-10-10,,Tennessee,W (44-21),16,27,59.3,238,2,50,193,3.9,2,77,431,5.6,11,10,3,24,6,70,2,0,2,Georgia,/cfb/boxscores/2020-10-10-georgia.html
4.0,2020-10-17,@,Alabama,L (24-41),18,40,45.0,269,2,30,145,4.8,1,70,414,5.9,11,7,2,20,6,52,0,3,3,Georgia,/cfb/boxscores/2020-10-17-alabama.html
5.0,2020-10-31,@,Kentucky,W (14-3),9,14,64.3,131,0,43,215,5.0,2,57,346,6.1,6,13,1,20,2,19,0,2,2,Georgia,/cfb/boxscores/2020-10-31-kentucky.html
6.0,2020-11-07,N,Florida,L (28-44),9,29,31.0,112,2,29,165,5.7,1,58,277,4.8,5,7,0,12,3,35,0,3,3,Georgia,/cfb/boxscores/2020-11-07-georgia.html
7.0,2020-11-21,,Mississippi State,W (31-24),28,38,73.7,401,4,23,8,0.3,0,61,409,6.7,15,2,1,18,5,60,0,0,0,Georgia,/cfb/boxscores/2020-11-21-georgia.html
8.0,2020-11-28,@,South Carolina,W (45-16),10,16,62.5,139,2,46,332,7.2,4,62,471,7.6,5,19,0,24,6,50,0,1,1,Georgia,/cfb/boxscores/2020-11-28-south-carolina.html
9.0,2020-12-12,@,Missouri,W (49-14),16,28,57.1,299,3,45,316,7.0,4,73,615,8.4,12,15,1,28,1,9,0,0,0,Georgia,/cfb/boxscores/2020-12-12-missouri.html
10.0,2021-01-01,N,Cincinnati*,W (24-21),27,39,69.2,404,1,24,45,1.9,1,63,449,7.1,13,4,2,19,6,66,1,1,2,Georgia,/cfb/boxscores/2021-01-01-cincinnati.html
1.0,2020-09-12,,Campbell,W (27-26),8,16,50.0,62,1,49,284,5.8,2,65,346,5.3,3,14,3,20,5,27,1,0,1,Georgia Southern,/cfb/boxscores/2020-09-12-georgia-southern.html
2.0,2020-09-26,@,Louisiana,L (18-20),11,18,61.1,255,1,49,192,3.9,1,67,447,6.7,7,13,1,21,2,10,1,1,2,Georgia Southern,/cfb/boxscores/2020-09-26-louisiana-lafayette.html
3.0,2020-10-03,@,Louisiana-Monroe,W (35-30),3,7,42.9,29,0,53,340,6.4,4,60,369,6.2,2,16,1,19,7,57,0,0,0,Georgia Southern,/cfb/boxscores/2020-10-03-louisiana-monroe.html
4.0,2020-10-17,,Massachusetts,W (41-0),12,17,70.6,128,3,40,309,7.7,2,57,437,7.7,6,13,1,20,4,40,1,0,1,Georgia Southern,/cfb/boxscores/2020-10-17-georgia-southern.html
5.0,2020-10-24,@,Coastal Carolina,L (14-28),8,22,36.4,99,0,37,119,3.2,1,59,218,3.7,5,6,1,12,5,31,0,2,2,Georgia Southern,/cfb/boxscores/2020-10-24-coastal-carolina.html
6.0,2020-10-29,,South Alabama,W (24-17),5,9,55.6,95,0,48,250,5.2,3,57,345,6.1,3,12,0,15,7,72,0,1,1,Georgia Southern,/cfb/boxscores/2020-10-29-georgia-southern.html
7.0,2020-11-07,,Troy,W (20-13),12,13,92.3,85,0,61,326,5.3,2,74,411,5.6,4,15,1,20,6,60,0,1,1,Georgia Southern,/cfb/boxscores/2020-11-07-georgia-southern.html
8.0,2020-11-14,,Texas State,W (40-38),6,9,66.7,51,0,63,388,6.2,4,72,439,6.1,1,19,1,21,4,40,1,1,2,Georgia Southern,/cfb/boxscores/2020-11-14-georgia-southern.html
9.0,2020-11-21,@,Army,L (27-28),9,13,69.2,136,2,32,175,5.5,1,45,311,6.9,4,7,1,12,3,15,0,1,1,Georgia Southern,/cfb/boxscores/2020-11-21-army.html
10.0,2020-11-28,@,Georgia State,L (24-30),6,10,60.0,74,0,47,296,6.3,3,57,370,6.5,3,10,0,13,3,23,1,1,2,Georgia Southern,/cfb/boxscores/2020-11-28-georgia-state.html
11.0,2020-12-05,,Florida Atlantic,W (20-3),3,12,25.0,70,0,59,269,4.6,1,71,339,4.8,3,15,0,18,3,35,0,0,0,Georgia Southern,/cfb/boxscores/2020-12-05-georgia-southern.html
12.0,2020-12-12,,Appalachian State,L (26-34),7,18,38.9,145,1,41,204,5.0,1,59,349,5.9,5,9,2,16,1,5,1,3,4,Georgia Southern,/cfb/boxscores/2020-12-12-georgia-southern.html
13.0,2020-12-23,N,Louisiana Tech*,W (38-3),7,12,58.3,126,1,57,322,5.6,4,69,448,6.5,3,13,1,17,3,25,0,0,0,Georgia Southern,/cfb/boxscores/2020-12-23-georgia-southern.html
1.0,2020-09-19,,Louisiana,L (31-34),22,39,56.4,196,1,52,223,4.3,3,91,419,4.6,11,13,2,26,6,38,1,1,2,Georgia State,/cfb/boxscores/2020-09-19-georgia-state.html
2.0,2020-10-03,,East Carolina,W (49-29),18,28,64.3,238,3,44,247,5.6,3,72,485,6.7,10,9,2,21,9,92,1,2,3,Georgia State,/cfb/boxscores/2020-10-03-georgia-state.html
3.0,2020-10-15,@,Arkansas State,L (52-59),18,35,51.4,314,3,41,269,6.6,3,76,583,7.7,11,10,4,25,10,96,1,0,1,Georgia State,/cfb/boxscores/2020-10-15-arkansas-state.html
4.0,2020-10-24,@,Troy,W (36-34),20,30,66.7,169,2,56,210,3.8,2,86,379,4.4,10,10,3,23,6,76,2,1,3,Georgia State,/cfb/boxscores/2020-10-24-troy.html
5.0,2020-10-31,,Coastal Carolina,L (0-51),6,12,50.0,30,0,28,76,2.7,0,40,106,2.7,1,4,0,5,4,50,1,1,2,Georgia State,/cfb/boxscores/2020-10-31-georgia-state.html
6.0,2020-11-07,,Louisiana-Monroe,W (52-34),20,32,62.5,241,3,49,263,5.4,4,81,504,6.2,9,14,0,23,5,59,1,0,1,Georgia State,/cfb/boxscores/2020-11-07-georgia-state.html
7.0,2020-11-14,@,Appalachian State,L (13-17),11,33,33.3,152,1,38,148,3.9,0,71,300,4.2,8,7,1,16,3,44,1,0,1,Georgia State,/cfb/boxscores/2020-11-14-appalachian-state.html
8.0,2020-11-21,@,South Alabama,W (31-14),19,28,67.9,334,0,44,222,5.0,4,72,556,7.7,13,6,0,19,5,70,1,3,4,Georgia State,/cfb/boxscores/2020-11-21-south-alabama.html
9.0,2020-11-28,,Georgia Southern,W (30-24),28,39,71.8,372,1,36,55,1.5,2,75,427,5.7,15,5,2,22,1,5,1,1,2,Georgia State,/cfb/boxscores/2020-11-28-georgia-state.html
10.0,2020-12-26,N,Western Kentucky*,W (39-21),17,31,54.8,257,4,55,227,4.1,1,86,484,5.6,12,13,2,27,6,57,0,1,1,Georgia State,/cfb/boxscores/2020-12-26-georgia-state.html
1.0,2020-09-12,@,Florida State,W (16-13),23,34,67.6,277,1,40,161,4.0,1,74,438,5.9,12,12,0,24,10,80,0,2,2,Georgia Tech,/cfb/boxscores/2020-09-12-florida-state.html
2.0,2020-09-19,,Central Florida,L (21-49),18,37,48.6,244,1,44,227,5.2,2,81,471,5.8,12,11,0,23,7,49,3,2,5,Georgia Tech,/cfb/boxscores/2020-09-19-georgia-tech.html
3.0,2020-09-26,@,Syracuse,L (20-37),15,32,46.9,178,1,52,275,5.3,2,84,453,5.4,7,14,2,23,15,104,1,4,5,Georgia Tech,/cfb/boxscores/2020-09-26-syracuse.html
4.0,2020-10-09,,Louisville,W (46-27),12,22,54.5,258,3,34,192,5.6,4,56,450,8.0,9,9,1,19,7,55,0,0,0,Georgia Tech,/cfb/boxscores/2020-10-09-georgia-tech.html
5.0,2020-10-17,,Clemson,L (7-73),6,14,42.9,81,1,44,123,2.8,0,58,204,3.5,2,4,1,7,3,40,2,1,3,Georgia Tech,/cfb/boxscores/2020-10-17-georgia-tech.html
6.0,2020-10-24,@,Boston College,L (27-48),18,32,56.3,256,2,33,106,3.2,2,65,362,5.6,11,3,5,19,10,62,2,1,3,Georgia Tech,/cfb/boxscores/2020-10-24-boston-college.html
7.0,2020-10-31,,Notre Dame,L (13-31),15,26,57.7,150,0,33,88,2.7,1,59,238,4.0,5,10,2,17,6,50,1,0,1,Georgia Tech,/cfb/boxscores/2020-10-31-georgia-tech.html
8.0,2020-11-28,,Duke,W (56-33),13,23,56.5,146,3,48,377,7.9,4,71,523,7.4,6,16,1,23,11,112,2,1,3,Georgia Tech,/cfb/boxscores/2020-11-28-georgia-tech.html
9.0,2020-12-05,@,North Carolina State,L (13-23),13,27,48.1,151,0,51,261,5.1,1,78,412,5.3,8,14,1,23,12,111,0,0,0,Georgia Tech,/cfb/boxscores/2020-12-05-north-carolina-state.html
10.0,2020-12-10,,Pittsburgh,L (20-34),19,36,52.8,250,2,29,98,3.4,1,65,348,5.4,13,6,2,21,8,86,1,2,3,Georgia Tech,/cfb/boxscores/2020-12-10-georgia-tech.html
1.0,2020-10-24,@,Fresno State,W (34-19),20,31,64.5,229,0,53,323,6.1,4,84,552,6.6,10,16,1,27,6,44,1,0,1,Hawaii,/cfb/boxscores/2020-10-24-fresno-state.html
2.0,2020-10-30,@,Wyoming,L (7-31),11,26,42.3,110,0,31,123,4.0,1,57,233,4.1,3,8,1,12,7,60,1,1,2,Hawaii,/cfb/boxscores/2020-10-30-wyoming.html
3.0,2020-11-07,,New Mexico,W (39-33),33,44,75.0,410,4,28,93,3.3,1,72,503,7.0,14,8,1,23,3,30,1,2,3,Hawaii,/cfb/boxscores/2020-11-07-hawaii.html
4.0,2020-11-14,@,San Diego State,L (10-34),17,35,48.6,209,1,35,64,1.8,0,70,273,3.9,8,6,0,14,4,35,2,1,3,Hawaii,/cfb/boxscores/2020-11-14-san-diego-state.html
5.0,2020-11-21,,Boise State,L (32-40),25,48,52.1,253,3,35,141,4.0,1,83,394,4.7,13,7,5,25,6,45,0,0,0,Hawaii,/cfb/boxscores/2020-11-21-hawaii.html
6.0,2020-11-28,,Nevada,W (24-21),26,32,81.3,246,1,36,119,3.3,2,68,365,5.4,17,4,4,25,4,30,0,0,0,Hawaii,/cfb/boxscores/2020-11-28-hawaii.html
7.0,2020-12-05,,San Jose State,L (24-35),28,43,65.1,238,2,26,101,3.9,1,69,339,4.9,14,6,2,22,5,30,0,1,1,Hawaii,/cfb/boxscores/2020-12-05-hawaii.html
8.0,2020-12-12,,Nevada-Las Vegas,W (38-21),20,33,60.6,252,0,46,278,6.0,5,79,530,6.7,9,12,3,24,10,72,1,1,2,Hawaii,/cfb/boxscores/2020-12-12-hawaii.html
9.0,2020-12-24,N,Houston*,W (28-14),15,23,65.2,136,3,34,131,3.9,0,57,267,4.7,4,7,0,11,3,40,0,0,0,Hawaii,/cfb/boxscores/2020-12-24-houston.html
1.0,2020-10-08,,Tulane,W (49-31),20,33,60.6,319,2,43,157,3.7,4,76,476,6.3,11,9,2,22,10,84,3,2,5,Houston,/cfb/boxscores/2020-10-08-houston.html
2.0,2020-10-16,,Brigham Young,L (26-43),21,33,63.6,310,2,44,128,2.9,1,77,438,5.7,16,8,2,26,10,113,0,0,0,Houston,/cfb/boxscores/2020-10-16-houston.html
3.0,2020-10-24,@,Navy,W (37-21),26,37,70.3,334,3,31,86,2.8,1,68,420,6.2,13,8,2,23,9,77,1,0,1,Houston,/cfb/boxscores/2020-10-24-navy.html
4.0,2020-10-31,,Central Florida,L (21-44),22,42,52.4,269,1,37,165,4.5,1,79,434,5.5,14,11,1,26,7,60,0,2,2,Houston,/cfb/boxscores/2020-10-31-houston.html
5.0,2020-11-07,@,Cincinnati,L (10-38),20,34,58.8,189,0,28,93,3.3,1,62,282,4.5,8,6,1,15,5,37,1,1,2,Houston,/cfb/boxscores/2020-11-07-cincinnati.html
6.0,2020-11-14,,South Florida,W (56-21),15,26,57.7,186,3,37,319,8.6,3,63,505,8.0,9,15,1,25,8,75,0,1,1,Houston,/cfb/boxscores/2020-11-14-houston.html
7.0,2020-12-12,@,Memphis,L (27-30),30,49,61.2,270,2,35,139,4.0,1,84,409,4.9,19,7,0,26,7,75,1,1,2,Houston,/cfb/boxscores/2020-12-12-memphis.html
8.0,2020-12-24,N,Hawaii*,L (14-28),21,43,48.8,249,2,38,58,1.5,0,81,307,3.8,13,5,2,20,5,25,0,3,3,Houston,/cfb/boxscores/2020-12-24-houston.html
1.0,2020-10-23,@,Wisconsin,L (7-45),8,22,36.4,87,0,25,131,5.2,0,47,218,4.6,4,4,0,8,5,60,1,1,2,Illinois,/cfb/boxscores/2020-10-23-wisconsin.html
2.0,2020-10-31,,Purdue,L (24-31),20,33,60.6,295,2,43,177,4.1,1,76,472,6.2,12,9,6,27,7,75,2,2,4,Illinois,/cfb/boxscores/2020-10-31-illinois.html
3.0,2020-11-07,,Minnesota,L (14-41),6,17,35.3,106,1,36,181,5.0,1,53,287,5.4,4,9,1,14,12,120,0,0,0,Illinois,/cfb/boxscores/2020-11-07-illinois.html
4.0,2020-11-14,@,Rutgers,W (23-20),7,18,38.9,104,0,59,338,5.7,2,77,442,5.7,4,15,4,23,4,40,1,0,1,Illinois,/cfb/boxscores/2020-11-14-rutgers.html
5.0,2020-11-21,@,Nebraska,W (41-23),18,25,72.0,205,1,52,285,5.5,4,77,490,6.4,9,14,2,25,3,31,0,0,0,Illinois,/cfb/boxscores/2020-11-21-nebraska.html
6.0,2020-12-05,,Iowa,L (21-35),17,35,48.6,199,3,38,149,3.9,0,73,348,4.8,11,9,0,20,3,30,0,0,0,Illinois,/cfb/boxscores/2020-12-05-illinois.html
7.0,2020-12-12,@,Northwestern,L (10-28),7,22,31.8,107,1,35,155,4.4,0,57,262,4.6,5,9,0,14,4,35,0,0,0,Illinois,/cfb/boxscores/2020-12-12-northwestern.html
8.0,2020-12-19,@,Penn State,L (21-56),8,22,36.4,120,2,38,153,4.0,1,60,273,4.6,4,8,0,12,1,15,1,1,2,Illinois,/cfb/boxscores/2020-12-19-penn-state.html
1.0,2020-10-24,,Penn State,W (36-35),19,36,52.8,170,1,26,41,1.6,3,62,211,3.4,9,5,2,16,4,36,1,1,2,Indiana,/cfb/boxscores/2020-10-24-indiana.html
2.0,2020-10-31,@,Rutgers,W (37-21),17,26,65.4,238,3,34,134,3.9,1,60,372,6.2,9,7,4,20,11,119,0,0,0,Indiana,/cfb/boxscores/2020-10-31-rutgers.html
3.0,2020-11-07,,Michigan,W (38-21),30,50,60.0,342,3,38,118,3.1,2,88,460,5.2,18,7,3,28,4,50,0,0,0,Indiana,/cfb/boxscores/2020-11-07-indiana.html
4.0,2020-11-14,@,Michigan State,W (24-0),25,38,65.8,320,2,39,113,2.9,1,77,433,5.6,12,8,1,21,4,38,0,2,2,Indiana,/cfb/boxscores/2020-11-14-michigan-state.html
5.0,2020-11-21,@,Ohio State,L (35-42),27,51,52.9,491,5,16,-1,-0.1,0,67,490,7.3,17,2,0,19,2,30,3,1,4,Indiana,/cfb/boxscores/2020-11-21-ohio-state.html
6.0,2020-11-28,,Maryland,W (27-11),11,24,45.8,115,0,48,234,4.9,3,72,349,4.8,5,9,3,17,3,20,1,0,1,Indiana,/cfb/boxscores/2020-11-28-indiana.html
7.0,2020-12-05,@,Wisconsin,W (14-6),13,22,59.1,130,2,31,87,2.8,0,53,217,4.1,6,6,3,15,1,15,1,0,1,Indiana,/cfb/boxscores/2020-12-05-wisconsin.html
8.0,2021-01-02,N,Mississippi*,L (20-26),26,45,57.8,201,0,40,168,4.2,2,85,369,4.3,10,12,4,26,5,50,1,1,2,Indiana,/cfb/boxscores/2021-01-02-indiana.html
1.0,2020-10-24,@,Purdue,L (20-24),22,39,56.4,265,0,36,195,5.4,2,75,460,6.1,10,9,0,19,10,100,2,0,2,Iowa,/cfb/boxscores/2020-10-24-purdue.html
2.0,2020-10-31,,Northwestern,L (20-21),26,51,51.0,216,1,23,77,3.3,1,74,293,4.0,11,7,2,20,3,20,0,3,3,Iowa,/cfb/boxscores/2020-10-31-iowa.html
3.0,2020-11-07,,Michigan State,W (49-7),16,29,55.2,179,1,41,226,5.5,4,70,405,5.8,10,7,2,19,6,35,0,0,0,Iowa,/cfb/boxscores/2020-11-07-iowa.html
4.0,2020-11-13,@,Minnesota,W (35-7),9,18,50.0,111,1,35,235,6.7,4,53,346,6.5,7,12,1,20,2,25,0,1,1,Iowa,/cfb/boxscores/2020-11-13-minnesota.html
5.0,2020-11-21,@,Penn State,W (41-21),18,28,64.3,186,0,46,175,3.8,4,74,361,4.9,11,12,1,24,6,45,1,0,1,Iowa,/cfb/boxscores/2020-11-21-penn-state.html
6.0,2020-11-27,,Nebraska,W (26-20),18,30,60.0,193,1,45,129,2.9,1,75,322,4.3,12,8,2,22,2,20,0,1,1,Iowa,/cfb/boxscores/2020-11-27-iowa.html
7.0,2020-12-05,@,Illinois,W (35-21),18,28,64.3,220,3,38,204,5.4,1,66,424,6.4,13,9,0,22,3,22,0,0,0,Iowa,/cfb/boxscores/2020-12-05-illinois.html
8.0,2020-12-12,,Wisconsin,W (28-7),14,25,56.0,211,2,32,127,4.0,1,57,338,5.9,8,4,1,13,6,50,1,0,1,Iowa,/cfb/boxscores/2020-12-12-iowa.html
1.0,2020-09-12,,Louisiana,L (14-31),16,35,45.7,145,0,36,158,4.4,2,71,303,4.3,7,10,1,18,3,24,1,1,2,Iowa State,/cfb/boxscores/2020-09-12-iowa-state.html
2.0,2020-09-26,@,TCU,W (37-34),18,23,78.3,211,1,28,212,7.6,4,51,423,8.3,8,6,0,14,3,25,1,0,1,Iowa State,/cfb/boxscores/2020-09-26-texas-christian.html
3.0,2020-10-03,,Oklahoma,W (37-30),13,25,52.0,282,1,31,135,4.4,3,56,417,7.4,11,8,6,25,9,90,1,0,1,Iowa State,/cfb/boxscores/2020-10-03-iowa-state.html
4.0,2020-10-10,,Texas Tech,W (31-15),32,43,74.4,302,2,43,214,5.0,2,86,516,6.0,14,15,0,29,6,40,1,0,1,Iowa State,/cfb/boxscores/2020-10-10-iowa-state.html
5.0,2020-10-24,@,Oklahoma State,L (21-24),19,34,55.9,162,1,33,227,6.9,2,67,389,5.8,9,8,1,18,9,70,0,1,1,Iowa State,/cfb/boxscores/2020-10-24-oklahoma-state.html
6.0,2020-10-31,@,Kansas,W (52-22),25,36,69.4,294,3,35,258,7.4,4,71,552,7.8,14,12,0,26,4,45,0,1,1,Iowa State,/cfb/boxscores/2020-10-31-kansas.html
7.0,2020-11-07,,Baylor,W (38-31),15,24,62.5,164,3,41,198,4.8,2,65,362,5.6,12,10,1,23,1,5,1,3,4,Iowa State,/cfb/boxscores/2020-11-07-iowa-state.html
8.0,2020-11-21,,Kansas State,W (45-0),19,25,76.0,299,3,44,240,5.5,3,69,539,7.8,11,14,1,26,4,30,0,0,0,Iowa State,/cfb/boxscores/2020-11-21-iowa-state.html
9.0,2020-11-27,@,Texas,W (23-20),25,36,69.4,312,1,33,121,3.7,1,69,433,6.3,13,9,3,25,7,55,0,0,0,Iowa State,/cfb/boxscores/2020-11-27-texas.html
10.0,2020-12-05,,West Virginia,W (42-6),20,23,87.0,247,3,44,236,5.4,3,67,483,7.2,11,12,3,26,6,65,0,0,0,Iowa State,/cfb/boxscores/2020-12-05-iowa-state.html
11.0,2020-12-19,N,Oklahoma,L (21-27),27,40,67.5,322,1,31,113,3.6,2,71,435,6.1,15,3,2,20,5,42,0,3,3,Iowa State,/cfb/boxscores/2020-12-19-iowa-state.html
12.0,2021-01-02,N,Oregon*,W (34-17),20,29,69.0,156,1,56,228,4.1,3,85,384,4.5,10,14,1,25,4,20,0,0,0,Iowa State,/cfb/boxscores/2021-01-02-iowa-state.html
1.0,2020-09-12,,Coastal Carolina,L (23-38),21,35,60.0,189,2,38,178,4.7,1,73,367,5.0,9,11,3,23,5,35,1,2,3,Kansas,/cfb/boxscores/2020-09-12-kansas.html
2.0,2020-09-26,@,Baylor,L (14-47),19,33,57.6,159,0,43,169,3.9,2,76,328,4.3,9,8,3,20,10,80,0,0,0,Kansas,/cfb/boxscores/2020-09-26-baylor.html
3.0,2020-10-03,,Oklahoma State,L (7-47),14,24,58.3,92,0,40,101,2.5,1,64,193,3.0,5,6,1,12,3,17,0,1,1,Kansas,/cfb/boxscores/2020-10-03-kansas.html
4.0,2020-10-17,@,West Virginia,L (17-38),14,23,60.9,95,1,31,62,2.0,0,54,157,2.9,3,3,1,7,9,90,0,2,2,Kansas,/cfb/boxscores/2020-10-17-west-virginia.html
5.0,2020-10-24,@,Kansas State,L (14-55),22,39,56.4,207,0,39,113,2.9,2,78,320,4.1,11,5,2,18,3,29,1,1,2,Kansas,/cfb/boxscores/2020-10-24-kansas-state.html
6.0,2020-10-31,,Iowa State,L (22-52),18,33,54.5,167,0,34,73,2.1,2,67,240,3.6,8,6,1,15,3,25,1,1,2,Kansas,/cfb/boxscores/2020-10-31-kansas.html
7.0,2020-11-07,@,Oklahoma,L (9-62),14,35,40.0,151,1,42,95,2.3,0,77,246,3.2,7,8,1,16,9,55,0,2,2,Kansas,/cfb/boxscores/2020-11-07-oklahoma.html
8.0,2020-11-28,,TCU,L (23-59),16,32,50.0,227,3,43,41,1.0,0,75,268,3.6,10,5,3,18,4,36,1,1,2,Kansas,/cfb/boxscores/2020-11-28-kansas.html
9.0,2020-12-05,@,Texas Tech,L (13-16),17,29,58.6,102,0,44,112,2.5,1,73,214,2.9,5,7,2,14,5,51,0,0,0,Kansas,/cfb/boxscores/2020-12-05-texas-tech.html
1.0,2020-09-12,,Arkansas State,L (31-35),18,30,60.0,283,2,39,91,2.3,2,69,374,5.4,12,6,3,21,8,85,0,0,0,Kansas State,/cfb/boxscores/2020-09-12-kansas-state.html
2.0,2020-09-26,@,Oklahoma,W (38-35),18,25,72.0,334,1,25,58,2.3,4,50,392,7.8,6,3,1,10,13,108,0,0,0,Kansas State,/cfb/boxscores/2020-09-26-oklahoma.html
3.0,2020-10-03,,Texas Tech,W (31-21),12,22,54.5,206,2,42,198,4.7,2,64,404,6.3,7,11,2,20,4,35,0,0,0,Kansas State,/cfb/boxscores/2020-10-03-kansas-state.html
4.0,2020-10-10,@,TCU,W (21-14),8,19,42.1,117,0,38,172,4.5,1,57,289,5.1,4,6,2,12,4,45,0,1,1,Kansas State,/cfb/boxscores/2020-10-10-texas-christian.html
5.0,2020-10-24,,Kansas,W (55-14),18,28,64.3,252,2,33,129,3.9,2,61,381,6.2,10,6,1,17,10,81,1,0,1,Kansas State,/cfb/boxscores/2020-10-24-kansas-state.html
6.0,2020-10-31,@,West Virginia,L (10-37),19,37,51.4,184,1,23,41,1.8,0,60,225,3.8,9,3,1,13,5,28,0,3,3,Kansas State,/cfb/boxscores/2020-10-31-west-virginia.html
7.0,2020-11-07,,Oklahoma State,L (18-20),10,22,45.5,143,1,44,227,5.2,1,66,370,5.6,5,9,1,15,6,50,1,1,2,Kansas State,/cfb/boxscores/2020-11-07-kansas-state.html
8.0,2020-11-21,@,Iowa State,L (0-45),9,19,47.4,76,0,28,73,2.6,0,47,149,3.2,3,5,1,9,4,20,2,1,3,Kansas State,/cfb/boxscores/2020-11-21-iowa-state.html
9.0,2020-11-28,@,Baylor,L (31-32),9,18,50.0,88,1,35,256,7.3,3,53,344,6.5,2,10,2,14,7,76,0,2,2,Kansas State,/cfb/boxscores/2020-11-28-baylor.html
10.0,2020-12-05,,Texas,L (31-69),16,27,59.3,174,2,46,274,6.0,2,73,448,6.1,9,13,2,24,3,21,1,2,3,Kansas State,/cfb/boxscores/2020-12-05-kansas-state.html
1.0,2020-11-04,,Eastern Michigan,W (27-23),21,29,72.4,219,2,42,236,5.6,2,71,455,6.4,13,13,2,28,9,78,0,1,1,Kent State,/cfb/boxscores/2020-11-04-kent-state.html
2.0,2020-11-10,@,Bowling Green State,W (62-24),23,35,65.7,372,5,58,295,5.1,3,93,667,7.2,15,17,2,34,9,70,0,0,0,Kent State,/cfb/boxscores/2020-11-10-bowling-green-state.html
3.0,2020-11-17,,Akron,W (69-35),24,27,88.9,360,4,51,390,7.6,6,78,750,9.6,16,19,2,37,8,80,2,0,2,Kent State,/cfb/boxscores/2020-11-17-kent-state.html
4.0,2020-11-28,@,Buffalo,L (41-70),22,35,62.9,343,3,45,235,5.2,2,80,578,7.2,12,12,6,30,11,97,0,1,1,Kent State,/cfb/boxscores/2020-11-28-buffalo.html
1.0,2020-09-26,@,Auburn,L (13-29),24,38,63.2,239,1,40,145,3.6,1,78,384,4.9,10,10,1,21,4,40,2,1,3,Kentucky,/cfb/boxscores/2020-09-26-auburn.html
2.0,2020-10-03,,Mississippi,L (41-42),14,18,77.8,151,0,56,408,7.3,6,74,559,7.6,10,15,1,26,8,81,1,0,1,Kentucky,/cfb/boxscores/2020-10-03-kentucky.html
3.0,2020-10-10,,Mississippi State,W (24-2),8,21,38.1,73,1,32,84,2.6,1,53,157,3.0,4,6,0,10,3,25,1,0,1,Kentucky,/cfb/boxscores/2020-10-10-kentucky.html
4.0,2020-10-17,@,Tennessee,W (34-7),13,16,81.3,107,1,45,187,4.2,1,61,294,4.8,7,9,2,18,1,10,1,0,1,Kentucky,/cfb/boxscores/2020-10-17-tennessee.html
5.0,2020-10-24,@,Missouri,L (10-20),5,14,35.7,50,1,22,95,4.3,0,36,145,4.0,1,5,2,8,1,10,1,0,1,Kentucky,/cfb/boxscores/2020-10-24-missouri.html
6.0,2020-10-31,,Georgia,L (3-14),15,25,60.0,91,0,39,138,3.5,0,64,229,3.6,3,11,1,15,6,54,1,0,1,Kentucky,/cfb/boxscores/2020-10-31-kentucky.html
7.0,2020-11-14,,Vanderbilt,W (38-35),16,20,80.0,150,2,35,308,8.8,3,55,458,8.3,6,16,1,23,10,89,0,0,0,Kentucky,/cfb/boxscores/2020-11-14-kentucky.html
8.0,2020-11-21,@,Alabama,L (3-63),10,25,40.0,120,0,32,59,1.8,0,57,179,3.1,6,5,1,12,7,69,0,1,1,Kentucky,/cfb/boxscores/2020-11-21-alabama.html
9.0,2020-11-28,@,Florida,L (10-34),10,19,52.6,62,1,43,159,3.7,0,62,221,3.6,4,9,2,15,8,74,0,3,3,Kentucky,/cfb/boxscores/2020-11-28-florida.html
10.0,2020-12-05,,South Carolina,W (41-18),17,26,65.4,201,0,45,291,6.5,5,71,492,6.9,9,13,2,24,5,60,0,0,0,Kentucky,/cfb/boxscores/2020-12-05-kentucky.html
11.0,2021-01-02,N,North Carolina State*,W (23-21),13,21,61.9,92,0,44,291,6.6,2,65,383,5.9,4,11,4,19,10,103,0,0,0,Kentucky,/cfb/boxscores/2021-01-02-kentucky.html
1.0,2020-09-19,@,Western Kentucky,W (30-24),13,21,61.9,133,0,58,354,6.1,4,79,487,6.2,6,20,1,27,8,89,0,0,0,Liberty,/cfb/boxscores/2020-09-19-western-kentucky.html
2.0,2020-09-26,,Florida International,W (36-34),25,32,78.1,308,2,47,219,4.7,2,79,527,6.7,13,13,5,31,4,40,0,0,0,Liberty,/cfb/boxscores/2020-09-26-liberty.html
3.0,2020-10-03,,North Alabama,W (28-7),15,25,60.0,107,4,40,250,6.3,0,65,357,5.5,8,13,1,22,8,75,0,1,1,Liberty,/cfb/boxscores/2020-10-03-liberty.html
4.0,2020-10-10,,Louisiana-Monroe,W (40-7),13,31,41.9,220,0,39,180,4.6,2,70,400,5.7,9,9,2,20,7,50,1,1,2,Liberty,/cfb/boxscores/2020-10-10-liberty.html
5.0,2020-10-17,@,Syracuse,W (38-21),16,20,80.0,182,1,48,338,7.0,4,68,520,7.6,6,16,2,24,4,50,2,0,2,Liberty,/cfb/boxscores/2020-10-17-syracuse.html
6.0,2020-10-24,,Southern Mississippi,W (56-35),24,32,75.0,345,6,37,192,5.2,2,69,537,7.8,13,11,1,25,4,50,1,0,1,Liberty,/cfb/boxscores/2020-10-24-liberty.html
7.0,2020-11-07,@,Virginia Tech,W (38-35),20,30,66.7,217,3,50,249,5.0,2,80,466,5.8,9,18,2,29,8,50,2,0,2,Liberty,/cfb/boxscores/2020-11-07-virginia-tech.html
8.0,2020-11-14,,Western Carolina,W (58-14),18,24,75.0,379,4,41,254,6.2,4,65,633,9.7,11,10,0,21,7,77,2,0,2,Liberty,/cfb/boxscores/2020-11-14-liberty.html
9.0,2020-11-21,@,North Carolina State,L (14-15),13,32,40.6,172,2,38,107,2.8,0,70,279,4.0,8,5,4,17,7,45,0,3,3,Liberty,/cfb/boxscores/2020-11-21-north-carolina-state.html
10.0,2020-11-27,,Massachusetts,W (45-0),17,31,54.8,251,3,44,378,8.6,3,75,629,8.4,11,19,1,31,4,45,0,0,0,Liberty,/cfb/boxscores/2020-11-27-liberty.html
11.0,2020-12-26,N,Coastal Carolina*,W (37-34),19,29,65.5,210,0,42,255,6.1,4,71,465,6.5,10,14,1,25,5,53,1,2,3,Liberty,/cfb/boxscores/2020-12-26-coastal-carolina.html
1.0,2020-09-12,@,Iowa State,W (31-14),13,21,61.9,154,1,35,118,3.4,1,56,272,4.9,6,8,0,14,2,22,0,0,0,Louisiana,/cfb/boxscores/2020-09-12-iowa-state.html
2.0,2020-09-19,@,Georgia State,W (34-31),21,37,56.8,279,2,39,240,6.2,3,76,519,6.8,13,9,1,23,4,54,0,2,2,Louisiana,/cfb/boxscores/2020-09-19-georgia-state.html
3.0,2020-09-26,,Georgia Southern,W (20-18),18,33,54.5,290,1,25,148,5.9,1,58,438,7.6,12,5,1,18,6,55,0,1,1,Louisiana,/cfb/boxscores/2020-09-26-louisiana-lafayette.html
4.0,2020-10-14,,Coastal Carolina,L (27-30),15,25,60.0,177,1,30,236,7.9,3,55,413,7.5,8,10,1,19,6,50,0,1,1,Louisiana,/cfb/boxscores/2020-10-14-louisiana-lafayette.html
5.0,2020-10-23,@,Alabama-Birmingham,W (24-20),12,20,60.0,152,2,42,134,3.2,0,62,286,4.6,5,9,3,17,6,52,0,0,0,Louisiana,/cfb/boxscores/2020-10-23-alabama-birmingham.html
6.0,2020-10-31,@,Texas State,W (44-34),22,34,64.7,332,2,50,282,5.6,4,84,614,7.3,11,19,1,31,11,122,3,1,4,Louisiana,/cfb/boxscores/2020-10-31-texas-state.html
7.0,2020-11-07,,Arkansas State,W (27-20),17,29,58.6,244,1,38,196,5.2,2,67,440,6.6,9,8,2,19,5,72,0,1,1,Louisiana,/cfb/boxscores/2020-11-07-louisiana-lafayette.html
8.0,2020-11-14,,South Alabama,W (38-10),21,35,60.0,252,3,37,254,6.9,2,72,506,7.0,11,11,1,23,10,94,1,1,2,Louisiana,/cfb/boxscores/2020-11-14-louisiana-lafayette.html
9.0,2020-11-28,@,Louisiana-Monroe,W (70-20),21,29,72.4,167,4,42,344,8.2,5,71,511,7.2,10,15,1,26,6,51,1,0,1,Louisiana,/cfb/boxscores/2020-11-28-louisiana-monroe.html
10.0,2020-12-04,@,Appalachian State,W (24-21),8,24,33.3,101,1,45,126,2.8,2,69,227,3.3,4,13,1,18,2,20,0,0,0,Louisiana,/cfb/boxscores/2020-12-04-appalachian-state.html
11.0,2020-12-26,N,UTSA*,W (31-24),12,23,52.2,146,2,43,268,6.2,2,66,414,6.3,6,13,4,23,10,84,1,0,1,Louisiana,/cfb/boxscores/2020-12-26-texas-san-antonio.html
1.0,2020-09-19,@,Southern Mississippi,W (31-30),24,35,68.6,218,4,42,163,3.9,0,77,381,4.9,12,13,1,26,7,48,0,1,1,Louisiana Tech,/cfb/boxscores/2020-09-19-southern-mississippi.html
2.0,2020-09-26,,Houston Christian,W (66-38),23,38,60.5,360,6,35,182,5.2,3,73,542,7.4,15,10,7,32,5,45,0,1,1,Louisiana Tech,/cfb/boxscores/2020-09-26-louisiana-tech.html
3.0,2020-10-02,@,Brigham Young,L (14-45),22,33,66.7,239,2,31,74,2.4,0,64,313,4.9,9,8,2,19,7,58,0,2,2,Louisiana Tech,/cfb/boxscores/2020-10-02-brigham-young.html
4.0,2020-10-10,,UTEP,W (21-17),14,28,50.0,119,0,42,91,2.2,3,70,210,3.0,5,9,2,16,3,35,0,0,0,Louisiana Tech,/cfb/boxscores/2020-10-10-louisiana-tech.html
5.0,2020-10-17,,Marshall,L (17-35),26,34,76.5,260,2,24,7,0.3,0,58,267,4.6,12,3,2,17,3,23,0,1,1,Louisiana Tech,/cfb/boxscores/2020-10-17-louisiana-tech.html
6.0,2020-10-24,@,UTSA,L (26-27),25,39,64.1,169,1,27,78,2.9,0,66,247,3.7,8,5,2,15,4,55,1,1,2,Louisiana Tech,/cfb/boxscores/2020-10-24-texas-san-antonio.html
7.0,2020-10-31,,Alabama-Birmingham,W (37-34),29,46,63.0,332,3,29,49,1.7,0,75,381,5.1,15,3,2,20,6,52,0,1,1,Louisiana Tech,/cfb/boxscores/2020-10-31-louisiana-tech.html
8.0,2020-12-03,@,North Texas,W (42-31),19,31,61.3,158,2,50,183,3.7,4,81,341,4.2,10,11,3,24,4,33,0,1,1,Louisiana Tech,/cfb/boxscores/2020-12-03-north-texas.html
9.0,2020-12-12,@,TCU,L (10-52),20,36,55.6,192,1,37,52,1.4,0,73,244,3.3,10,5,0,15,7,67,1,2,3,Louisiana Tech,/cfb/boxscores/2020-12-12-texas-christian.html
10.0,2020-12-23,N,Georgia Southern*,L (3-38),19,39,48.7,119,0,27,113,4.2,0,66,232,3.5,7,7,1,15,4,40,0,4,4,Louisiana Tech,/cfb/boxscores/2020-12-23-georgia-southern.html
1.0,2020-09-12,@,Army,L (7-37),16,24,66.7,163,1,20,37,1.9,0,44,200,4.5,5,2,2,9,4,30,1,1,2,Louisiana-Monroe,/cfb/boxscores/2020-09-12-army.html
2.0,2020-09-19,,Texas State,L (17-38),35,53,66.0,377,2,26,67,2.6,0,79,444,5.6,19,5,1,25,5,47,1,1,2,Louisiana-Monroe,/cfb/boxscores/2020-09-19-louisiana-monroe.html
3.0,2020-09-26,,UTEP,L (6-31),19,31,61.3,186,1,14,7,0.5,0,45,193,4.3,6,0,0,6,7,72,0,1,1,Louisiana-Monroe,/cfb/boxscores/2020-09-26-louisiana-monroe.html
4.0,2020-10-03,,Georgia Southern,L (30-35),31,55,56.4,334,2,18,92,5.1,2,73,426,5.8,15,6,3,24,5,45,0,0,0,Louisiana-Monroe,/cfb/boxscores/2020-10-03-louisiana-monroe.html
5.0,2020-10-10,@,Liberty,L (7-40),16,35,45.7,120,1,26,78,3.0,0,61,198,3.2,6,3,1,10,11,81,1,2,3,Louisiana-Monroe,/cfb/boxscores/2020-10-10-liberty.html
6.0,2020-10-24,@,South Alabama,L (14-38),22,33,66.7,282,1,28,98,3.5,1,61,380,6.2,13,5,2,20,2,30,1,1,2,Louisiana-Monroe,/cfb/boxscores/2020-10-24-south-alabama.html
7.0,2020-10-31,,Appalachian State,L (13-31),22,41,53.7,154,1,21,68,3.2,1,62,222,3.6,11,5,0,16,3,40,0,3,3,Louisiana-Monroe,/cfb/boxscores/2020-10-31-louisiana-monroe.html
8.0,2020-11-07,@,Georgia State,L (34-52),26,42,61.9,339,3,27,85,3.1,2,69,424,6.1,15,5,3,23,1,17,2,1,3,Louisiana-Monroe,/cfb/boxscores/2020-11-07-georgia-state.html
9.0,2020-11-28,,Louisiana,L (20-70),15,34,44.1,122,1,32,125,3.9,1,66,247,3.7,7,5,2,14,4,34,1,2,3,Louisiana-Monroe,/cfb/boxscores/2020-11-28-louisiana-monroe.html
10.0,2020-12-05,@,Arkansas State,L (15-48),21,35,60.0,213,1,36,110,3.1,1,71,323,4.5,10,8,0,18,6,41,0,0,0,Louisiana-Monroe,/cfb/boxscores/2020-12-05-arkansas-state.html
1.0,2020-09-12,,Western Kentucky,W (35-21),19,34,55.9,343,3,38,144,3.8,2,72,487,6.8,12,10,0,22,3,30,1,1,2,Louisville,/cfb/boxscores/2020-09-12-louisville.html
2.0,2020-09-19,,Miami (FL),L (34-47),26,36,72.2,307,3,49,209,4.3,1,85,516,6.1,16,11,2,29,7,70,2,1,3,Louisville,/cfb/boxscores/2020-09-19-louisville.html
3.0,2020-09-26,@,Pittsburgh,L (20-23),9,21,42.9,107,1,30,116,3.9,1,51,223,4.4,5,3,2,10,3,22,0,3,3,Louisville,/cfb/boxscores/2020-09-26-pittsburgh.html
4.0,2020-10-09,@,Georgia Tech,L (27-46),19,33,57.6,229,2,48,242,5.0,2,81,471,5.8,10,13,1,24,9,78,3,0,3,Louisville,/cfb/boxscores/2020-10-09-georgia-tech.html
5.0,2020-10-17,@,Notre Dame,L (7-12),17,21,81.0,137,1,23,96,4.2,0,44,233,5.3,7,6,1,13,7,60,0,0,0,Louisville,/cfb/boxscores/2020-10-17-notre-dame.html
6.0,2020-10-24,,Florida State,W (48-16),16,24,66.7,278,2,37,291,7.9,4,61,569,9.3,8,22,10,22,7,67,1,0,1,Louisville,/cfb/boxscores/2020-10-24-louisville.html
7.0,2020-10-31,,Virginia Tech,L (35-42),23,36,63.9,350,3,29,198,6.8,2,65,548,8.4,16,6,1,23,7,60,0,3,3,Louisville,/cfb/boxscores/2020-10-31-louisville.html
8.0,2020-11-14,@,Virginia,L (17-31),13,21,61.9,161,0,39,317,8.1,2,60,478,8.0,7,11,0,18,7,64,2,1,3,Louisville,/cfb/boxscores/2020-11-14-virginia.html
9.0,2020-11-20,,Syracuse,W (30-0),24,34,70.6,279,1,45,134,3.0,2,79,413,5.2,13,10,3,26,7,48,1,2,3,Louisville,/cfb/boxscores/2020-11-20-louisville.html
10.0,2020-11-28,@,Boston College,L (27-34),19,31,61.3,296,2,35,199,5.7,1,66,495,7.5,11,11,1,23,4,41,2,1,3,Louisville,/cfb/boxscores/2020-11-28-boston-college.html
11.0,2020-12-12,,Wake Forest,W (45-21),17,23,73.9,199,2,47,254,5.4,4,70,453,6.5,8,10,1,19,7,32,0,0,0,Louisville,/cfb/boxscores/2020-12-12-louisville.html
1.0,2020-09-26,,Mississippi State,L (34-44),27,46,58.7,345,3,38,80,2.1,0,84,425,5.1,16,8,1,25,7,31,0,2,2,LSU,/cfb/boxscores/2020-09-26-louisiana-state.html
2.0,2020-10-03,@,Vanderbilt,W (41-7),23,37,62.2,337,4,32,161,5.0,1,69,498,7.2,17,10,1,28,4,30,0,1,1,LSU,/cfb/boxscores/2020-10-03-vanderbilt.html
3.0,2020-10-10,@,Missouri,L (41-45),29,48,60.4,430,4,20,49,2.5,1,68,479,7.0,17,3,0,20,4,30,0,0,0,LSU,/cfb/boxscores/2020-10-10-missouri.html
4.0,2020-10-24,,South Carolina,W (52-24),17,21,81.0,265,2,54,276,5.1,3,75,541,7.2,13,14,2,29,10,79,0,1,1,LSU,/cfb/boxscores/2020-10-24-louisiana-state.html
5.0,2020-10-31,@,Auburn,L (11-48),28,48,58.3,315,1,27,32,1.2,0,75,347,4.6,17,2,1,20,2,25,1,2,3,LSU,/cfb/boxscores/2020-10-31-auburn.html
6.0,2020-11-21,@,Arkansas,W (27-24),27,42,64.3,271,2,49,148,3.0,1,91,419,4.6,16,7,1,24,9,70,1,0,1,LSU,/cfb/boxscores/2020-11-21-arkansas.html
7.0,2020-11-28,@,Texas A&M,L (7-20),23,47,48.9,231,1,25,36,1.4,0,72,267,3.7,10,3,1,14,11,79,1,2,3,LSU,/cfb/boxscores/2020-11-28-texas-am.html
8.0,2020-12-05,,Alabama,L (17-55),25,45,55.6,254,1,27,98,3.6,1,72,352,4.9,12,7,2,21,4,30,1,0,1,LSU,/cfb/boxscores/2020-12-05-louisiana-state.html
9.0,2020-12-12,@,Florida,W (37-34),21,36,58.3,239,3,50,179,3.6,0,86,418,4.9,9,13,2,24,6,49,0,0,0,LSU,/cfb/boxscores/2020-12-12-florida.html
10.0,2020-12-19,,Mississippi,W (53-48),27,51,52.9,435,3,43,158,3.7,2,94,593,6.3,18,10,1,29,4,39,0,1,1,LSU,/cfb/boxscores/2020-12-19-louisiana-state.html
1.0,2020-09-05,,Eastern Kentucky,W (59-0),22,29,75.9,345,5,54,282,5.2,3,83,627,7.6,12,20,2,34,2,15,0,0,0,Marshall,/cfb/boxscores/2020-09-05-marshall.html
2.0,2020-09-19,,Appalachian State,W (17-7),11,25,44.0,163,0,45,216,4.8,2,70,379,5.4,7,12,3,22,11,117,0,1,1,Marshall,/cfb/boxscores/2020-09-19-marshall.html
3.0,2020-10-10,@,Western Kentucky,W (38-14),16,22,72.7,162,0,40,182,4.6,4,62,344,5.5,8,9,0,17,5,40,0,0,0,Marshall,/cfb/boxscores/2020-10-10-western-kentucky.html
4.0,2020-10-17,@,Louisiana Tech,W (35-17),19,24,79.2,227,2,47,175,3.7,3,71,402,5.7,12,12,1,25,5,69,1,1,2,Marshall,/cfb/boxscores/2020-10-17-louisiana-tech.html
5.0,2020-10-24,,Florida Atlantic,W (20-9),18,31,58.1,251,2,30,134,4.5,0,61,385,6.3,9,4,6,19,7,65,0,2,2,Marshall,/cfb/boxscores/2020-10-24-marshall.html
6.0,2020-11-07,,Massachusetts,W (51-10),21,32,65.6,228,3,41,267,6.5,4,73,495,6.8,12,16,5,33,4,43,0,0,0,Marshall,/cfb/boxscores/2020-11-07-marshall.html
7.0,2020-11-14,,Middle Tennessee State,W (42-14),25,37,67.6,336,5,38,184,4.8,1,75,520,6.9,16,8,2,26,7,75,1,0,1,Marshall,/cfb/boxscores/2020-11-14-marshall.html
8.0,2020-12-05,,Rice,L (0-20),18,35,51.4,165,0,28,80,2.9,0,63,245,3.9,11,7,1,19,8,80,0,5,5,Marshall,/cfb/boxscores/2020-12-05-marshall.html
9.0,2020-12-18,,Alabama-Birmingham,L (13-22),8,24,33.3,138,2,27,130,4.8,0,51,268,5.3,4,6,0,10,3,42,0,1,1,Marshall,/cfb/boxscores/2020-12-18-marshall.html
10.0,2020-12-25,N,Buffalo*,L (10-17),13,22,59.1,114,0,37,134,3.6,1,59,248,4.2,5,10,1,16,8,81,0,0,0,Marshall,/cfb/boxscores/2020-12-25-buffalo.html
1.0,2020-10-24,@,Northwestern,L (3-43),18,29,62.1,143,0,20,64,3.2,0,49,207,4.2,9,4,1,14,6,60,1,3,4,Maryland,/cfb/boxscores/2020-10-24-northwestern.html
2.0,2020-10-30,,Minnesota,W (45-44),26,35,74.3,394,3,31,281,9.1,3,66,675,10.2,15,12,1,28,10,97,1,1,2,Maryland,/cfb/boxscores/2020-10-30-maryland.html
3.0,2020-11-07,@,Penn State,W (35-19),18,26,69.2,282,3,35,123,3.5,1,61,405,6.6,10,6,0,16,8,55,0,0,0,Maryland,/cfb/boxscores/2020-11-07-penn-state.html
4.0,2020-11-28,@,Indiana,L (11-27),17,36,47.2,241,1,25,59,2.4,0,61,300,4.9,10,6,0,16,8,55,0,3,3,Maryland,/cfb/boxscores/2020-11-28-indiana.html
5.0,2020-12-12,,Rutgers,L (24-27),19,33,57.6,260,2,40,198,5.0,1,73,458,6.3,9,8,1,18,12,131,0,2,2,Maryland,/cfb/boxscores/2020-12-12-maryland.html
1.0,2020-10-17,@,Georgia Southern,L (0-41),13,21,61.9,80,0,32,111,3.5,0,53,191,3.6,5,4,1,10,5,29,0,2,2,Massachusetts,/cfb/boxscores/2020-10-17-georgia-southern.html
2.0,2020-11-07,@,Marshall,L (10-51),17,26,65.4,149,1,29,41,1.4,0,55,190,3.5,5,5,2,12,5,68,1,0,1,Massachusetts,/cfb/boxscores/2020-11-07-marshall.html
3.0,2020-11-20,@,Florida Atlantic,L (2-24),15,30,50.0,85,0,25,62,2.5,0,55,147,2.7,6,2,0,8,5,69,0,2,2,Massachusetts,/cfb/boxscores/2020-11-20-florida-atlantic.html
4.0,2020-11-27,@,Liberty,L (0-45),9,23,39.1,172,0,31,55,1.8,0,54,227,4.2,7,3,2,12,6,50,1,1,2,Massachusetts,/cfb/boxscores/2020-11-27-liberty.html
1.0,2020-09-05,,Arkansas State,W (37-24),27,37,73.0,280,4,43,230,5.3,1,80,510,6.4,15,13,1,29,12,102,0,1,1,Memphis,/cfb/boxscores/2020-09-05-memphis.html
2.0,2020-10-03,@,Southern Methodist,L (27-30),29,42,69.0,296,3,38,205,5.4,0,80,501,6.3,12,12,2,26,5,40,2,2,4,Memphis,/cfb/boxscores/2020-10-03-southern-methodist.html
3.0,2020-10-17,,Central Florida,W (50-49),34,50,68.0,486,6,45,217,4.8,1,95,703,7.4,21,13,7,41,7,44,1,0,1,Memphis,/cfb/boxscores/2020-10-17-memphis.html
4.0,2020-10-24,,Temple,W (41-29),17,36,47.2,313,4,41,176,4.3,1,77,489,6.4,10,10,4,24,7,71,2,1,3,Memphis,/cfb/boxscores/2020-10-24-memphis.html
5.0,2020-10-31,@,Cincinnati,L (10-49),18,35,51.4,316,1,29,5,0.2,0,64,321,5.0,10,2,3,15,4,50,1,0,1,Memphis,/cfb/boxscores/2020-10-31-cincinnati.html
6.0,2020-11-07,,South Florida,W (34-33),30,50,60.0,437,4,33,98,3.0,0,83,535,6.4,15,6,3,24,6,53,0,1,1,Memphis,/cfb/boxscores/2020-11-07-memphis.html
7.0,2020-11-21,,Stephen F. Austin,W (56-14),18,33,54.5,269,1,44,305,6.9,5,77,574,7.5,10,14,1,25,6,65,0,1,1,Memphis,/cfb/boxscores/2020-11-21-memphis.html
8.0,2020-11-28,@,Navy,W (10-7),18,32,56.3,205,1,26,75,2.9,0,58,280,4.8,8,3,1,12,5,25,1,0,1,Memphis,/cfb/boxscores/2020-11-28-navy.html
9.0,2020-12-05,@,Tulane,L (21-35),20,39,51.3,255,2,28,45,1.6,1,67,300,4.5,11,4,5,20,4,29,0,2,2,Memphis,/cfb/boxscores/2020-12-05-tulane.html
10.0,2020-12-12,,Houston,W (30-27),22,35,62.9,246,2,30,64,2.1,0,65,310,4.8,12,5,3,20,0,0,0,1,1,Memphis,/cfb/boxscores/2020-12-12-memphis.html
11.0,2020-12-23,N,Florida Atlantic*,W (25-10),22,34,64.7,284,3,35,185,5.3,0,69,469,6.8,11,13,0,24,5,41,2,1,3,Memphis,/cfb/boxscores/2020-12-23-florida-atlantic.html
1.0,2020-09-10,,Alabama-Birmingham,W (31-14),18,27,66.7,158,1,52,337,6.5,3,79,495,6.3,9,13,3,25,3,30,1,0,1,Miami (FL),/cfb/boxscores/2020-09-10-miami-fl.html
2.0,2020-09-19,@,Louisville,W (47-34),18,30,60.0,325,3,30,160,5.3,2,60,485,8.1,13,3,3,19,11,89,0,0,0,Miami (FL),/cfb/boxscores/2020-09-19-louisville.html
3.0,2020-09-26,,Florida State,W (52-10),33,48,68.8,317,3,37,200,5.4,4,85,517,6.1,14,13,6,33,8,80,2,0,2,Miami (FL),/cfb/boxscores/2020-09-26-miami-fl.html
4.0,2020-10-10,@,Clemson,L (17-42),12,29,41.4,121,0,25,89,3.6,1,54,210,3.9,3,4,2,9,15,135,0,3,3,Miami (FL),/cfb/boxscores/2020-10-10-clemson.html
5.0,2020-10-17,,Pittsburgh,W (31-19),16,31,51.6,222,4,42,109,2.6,0,73,331,4.5,8,10,3,21,5,55,0,2,2,Miami (FL),/cfb/boxscores/2020-10-17-miami-fl.html
6.0,2020-10-24,,Virginia,W (19-14),21,30,70.0,322,1,48,122,2.5,1,78,444,5.7,13,8,2,23,6,38,0,0,0,Miami (FL),/cfb/boxscores/2020-10-24-miami-fl.html
7.0,2020-11-06,@,North Carolina State,W (44-41),32,42,76.2,431,5,38,194,5.1,0,80,625,7.8,15,11,4,30,12,101,0,0,0,Miami (FL),/cfb/boxscores/2020-11-06-north-carolina-state.html
8.0,2020-11-14,@,Virginia Tech,W (25-24),24,38,63.2,255,1,48,131,2.7,2,86,386,4.5,14,12,0,26,8,77,0,0,0,Miami (FL),/cfb/boxscores/2020-11-14-virginia-tech.html
9.0,2020-12-05,@,Duke,W (48-0),17,26,65.4,304,3,42,220,5.2,3,68,524,7.7,10,13,1,24,3,26,1,0,1,Miami (FL),/cfb/boxscores/2020-12-05-duke.html
10.0,2020-12-12,,North Carolina,L (26-62),18,32,56.3,239,2,27,75,2.8,1,59,314,5.3,10,4,1,15,7,68,0,1,1,Miami (FL),/cfb/boxscores/2020-12-12-miami-fl.html
11.0,2020-12-29,N,Oklahoma State*,L (34-37),30,48,62.5,356,3,30,156,5.2,1,78,512,6.6,17,8,2,27,8,76,2,0,2,Miami (FL),/cfb/boxscores/2020-12-29-miami-fl.html
1.0,2020-11-04,,Ball State,W (38-31),21,32,65.6,288,3,42,134,3.2,2,74,422,5.7,14,7,5,26,4,35,1,0,1,Miami (OH),/cfb/boxscores/2020-11-04-miami-oh.html
2.0,2020-11-10,@,Buffalo,L (10-42),8,26,30.8,119,1,31,139,4.5,0,57,258,4.5,5,7,1,13,5,45,0,1,1,Miami (OH),/cfb/boxscores/2020-11-10-buffalo.html
3.0,2020-11-28,@,Akron,W (38-7),18,27,66.7,308,4,27,108,4.0,0,54,416,7.7,13,4,0,17,9,102,0,0,0,Miami (OH),/cfb/boxscores/2020-11-28-akron.html
1.0,2020-10-24,@,Minnesota,W (49-24),15,25,60.0,225,1,31,253,8.2,5,56,478,8.5,11,6,1,18,7,80,0,0,0,Michigan,/cfb/boxscores/2020-10-24-minnesota.html
2.0,2020-10-31,,Michigan State,L (24-27),32,52,61.5,300,0,34,152,4.5,3,86,452,5.3,18,9,1,28,10,86,0,0,0,Michigan,/cfb/boxscores/2020-10-31-michigan.html
3.0,2020-11-07,@,Indiana,L (21-38),18,34,52.9,344,3,18,13,0.7,0,52,357,6.9,15,1,1,17,8,89,0,2,2,Michigan,/cfb/boxscores/2020-11-07-indiana.html
4.0,2020-11-14,,Wisconsin,L (11-49),13,26,50.0,172,1,19,47,2.5,0,45,219,4.9,8,2,0,10,4,40,0,2,2,Michigan,/cfb/boxscores/2020-11-14-michigan.html
5.0,2020-11-21,@,Rutgers,W (48-42),32,48,66.7,349,4,43,147,3.4,2,91,496,5.5,16,9,4,29,5,40,1,0,1,Michigan,/cfb/boxscores/2020-11-21-rutgers.html
6.0,2020-11-28,,Penn State,L (17-27),13,28,46.4,112,0,27,174,6.4,2,55,286,5.2,3,9,2,14,1,10,1,0,1,Michigan,/cfb/boxscores/2020-11-28-michigan.html
1.0,2020-10-24,,Rutgers,L (27-38),31,43,72.1,319,3,39,50,1.3,0,82,369,4.5,15,5,3,23,7,52,5,2,7,Michigan State,/cfb/boxscores/2020-10-24-michigan-state.html
2.0,2020-10-31,@,Michigan,W (27-24),17,32,53.1,323,3,38,126,3.3,0,70,449,6.4,12,3,5,20,5,65,0,0,0,Michigan State,/cfb/boxscores/2020-10-31-michigan.html
3.0,2020-11-07,@,Iowa,L (7-49),17,38,44.7,227,0,32,59,1.8,1,70,286,4.1,9,1,0,10,8,55,0,3,3,Michigan State,/cfb/boxscores/2020-11-07-iowa.html
4.0,2020-11-14,,Indiana,L (0-24),13,27,48.1,131,0,24,60,2.5,0,51,191,3.7,5,4,0,9,6,61,1,3,4,Michigan State,/cfb/boxscores/2020-11-14-michigan-state.html
5.0,2020-11-28,,Northwestern,W (29-20),11,27,40.7,167,2,47,195,4.1,0,74,362,4.9,6,10,1,17,5,50,0,1,1,Michigan State,/cfb/boxscores/2020-11-28-michigan-state.html
6.0,2020-12-05,,Ohio State,L (12-52),21,36,58.3,180,0,28,81,2.9,1,64,261,4.1,10,2,1,13,10,101,2,2,4,Michigan State,/cfb/boxscores/2020-12-05-michigan-state.html
7.0,2020-12-12,@,Penn State,L (24-39),22,39,56.4,325,3,30,71,2.4,0,69,396,5.7,15,4,2,21,7,57,0,1,1,Michigan State,/cfb/boxscores/2020-12-12-penn-state.html
1.0,2020-09-05,@,Army,L (0-42),16,24,66.7,109,0,24,75,3.1,0,48,184,3.8,4,6,3,13,5,53,2,2,4,Middle Tennessee State,/cfb/boxscores/2020-09-05-army.html
2.0,2020-09-19,,Troy,L (14-47),21,34,61.8,154,1,28,87,3.1,1,62,241,3.9,9,4,2,15,5,35,0,3,3,Middle Tennessee State,/cfb/boxscores/2020-09-19-middle-tennessee-state.html
3.0,2020-09-25,@,UTSA,L (35-37),31,48,64.6,372,3,41,191,4.7,2,89,563,6.3,14,11,2,27,8,82,0,2,2,Middle Tennessee State,/cfb/boxscores/2020-09-25-texas-san-antonio.html
4.0,2020-10-03,,Western Kentucky,L (17-20),23,33,69.7,217,1,33,102,3.1,1,66,319,4.8,9,6,3,18,6,47,0,0,0,Middle Tennessee State,/cfb/boxscores/2020-10-03-middle-tennessee-state.html
5.0,2020-10-10,@,Florida International,W (31-28),23,41,56.1,268,2,38,136,3.6,2,79,404,5.1,12,10,1,23,6,55,0,2,2,Middle Tennessee State,/cfb/boxscores/2020-10-10-florida-international.html
6.0,2020-10-17,,North Texas,L (35-52),18,29,62.1,164,3,48,268,5.6,1,77,432,5.6,7,13,3,23,6,54,0,1,1,Middle Tennessee State,/cfb/boxscores/2020-10-17-middle-tennessee-state.html
7.0,2020-10-24,@,Rice,W (40-34),24,33,72.7,333,2,39,118,3.0,2,72,451,6.3,12,9,1,22,9,79,1,0,1,Middle Tennessee State,/cfb/boxscores/2020-10-24-rice.html
8.0,2020-11-14,@,Marshall,L (14-42),30,45,66.7,247,1,23,56,2.4,1,68,303,4.5,9,6,3,18,4,40,3,0,3,Middle Tennessee State,/cfb/boxscores/2020-11-14-marshall.html
9.0,2020-11-21,@,Troy,W (20-17),19,23,82.6,210,0,51,186,3.6,2,74,396,5.4,9,13,1,23,2,25,0,0,0,Middle Tennessee State,/cfb/boxscores/2020-11-21-troy.html
1.0,2020-10-24,,Michigan,L (24-49),18,31,58.1,197,1,41,129,3.1,2,72,326,4.5,8,11,2,21,5,39,1,1,2,Minnesota,/cfb/boxscores/2020-10-24-minnesota.html
2.0,2020-10-30,@,Maryland,L (44-45),10,15,66.7,189,1,50,262,5.2,5,65,451,6.9,9,12,3,24,3,21,0,0,0,Minnesota,/cfb/boxscores/2020-10-30-maryland.html
3.0,2020-11-07,@,Illinois,W (41-14),17,27,63.0,216,1,47,325,6.9,5,74,541,7.3,12,15,3,30,2,22,1,1,2,Minnesota,/cfb/boxscores/2020-11-07-illinois.html
4.0,2020-11-13,,Iowa,L (7-35),16,33,48.5,167,1,40,145,3.6,0,73,312,4.3,8,10,1,19,8,85,0,2,2,Minnesota,/cfb/boxscores/2020-11-13-minnesota.html
5.0,2020-11-20,,Purdue,W (34-31),15,22,68.2,264,0,41,130,3.2,5,63,394,6.3,10,9,1,20,4,41,0,0,0,Minnesota,/cfb/boxscores/2020-11-20-minnesota.html
6.0,2020-12-12,@,Nebraska,W (24-17),17,30,56.7,181,1,43,206,4.8,2,73,387,5.3,10,7,2,19,3,20,0,0,0,Minnesota,/cfb/boxscores/2020-12-12-nebraska.html
7.0,2020-12-19,@,Wisconsin,L (17-20),14,26,53.8,180,2,36,146,4.1,0,62,326,5.3,9,7,2,18,7,65,0,1,1,Minnesota,/cfb/boxscores/2020-12-19-wisconsin.html
1.0,2020-09-26,@,Louisiana State,W (44-34),36,60,60.0,623,5,16,9,0.6,0,76,632,8.3,22,2,0,24,7,40,2,2,4,Mississippi State,/cfb/boxscores/2020-09-26-louisiana-state.html
2.0,2020-10-03,,Arkansas,L (14-21),43,60,71.7,313,1,24,87,3.6,1,84,400,4.8,19,5,0,24,4,25,1,3,4,Mississippi State,/cfb/boxscores/2020-10-03-mississippi-state.html
3.0,2020-10-10,@,Kentucky,L (2-24),45,70,64.3,275,0,14,20,1.4,0,84,295,3.5,15,2,1,18,8,57,0,6,6,Mississippi State,/cfb/boxscores/2020-10-10-kentucky.html
4.0,2020-10-17,,Texas A&M,L (14-28),30,40,75.0,219,1,20,-2,-0.1,0,60,217,3.6,9,5,1,15,3,25,1,1,2,Mississippi State,/cfb/boxscores/2020-10-17-mississippi-state.html
5.0,2020-10-31,@,Alabama,L (0-41),28,48,58.3,163,0,15,37,2.5,0,63,200,3.2,7,3,2,12,9,85,1,2,3,Mississippi State,/cfb/boxscores/2020-10-31-alabama.html
6.0,2020-11-07,,Vanderbilt,W (24-17),35,46,76.1,226,1,11,-22,-2.0,2,57,204,3.6,9,3,2,14,8,92,0,0,0,Mississippi State,/cfb/boxscores/2020-11-07-mississippi-state.html
7.0,2020-11-21,@,Georgia,L (24-31),41,52,78.8,336,1,14,22,1.6,2,66,358,5.4,17,2,1,20,3,25,0,0,0,Mississippi State,/cfb/boxscores/2020-11-21-georgia.html
8.0,2020-11-28,@,Mississippi,L (24-31),45,62,72.6,440,3,16,39,2.4,0,78,479,6.1,18,3,2,23,5,47,1,0,1,Mississippi State,/cfb/boxscores/2020-11-28-mississippi.html
9.0,2020-12-12,,Auburn,L (10-24),30,51,58.8,221,1,16,19,1.2,0,67,240,3.6,10,4,3,17,7,90,0,2,2,Mississippi State,/cfb/boxscores/2020-12-12-mississippi-state.html
10.0,2020-12-19,,Missouri,W (51-32),21,38,55.3,295,3,28,151,5.4,1,66,446,6.8,15,5,4,24,7,73,2,2,4,Mississippi State,/cfb/boxscores/2020-12-19-mississippi-state.html
11.0,2020-12-31,N,Tulsa*,W (28-26),19,30,63.3,148,1,30,123,4.1,2,60,271,4.5,9,7,0,16,11,102,0,0,0,Mississippi State,/cfb/boxscores/2020-12-31-mississippi-state.html
1.0,2020-09-26,,Alabama,L (19-38),26,39,66.7,253,1,34,69,2.0,1,73,322,4.4,11,8,1,20,3,20,2,0,2,Missouri,/cfb/boxscores/2020-09-26-missouri.html
2.0,2020-10-03,@,Tennessee,L (12-35),14,25,56.0,218,0,37,126,3.4,1,62,344,5.5,9,6,0,15,6,49,0,1,1,Missouri,/cfb/boxscores/2020-10-03-tennessee.html
3.0,2020-10-10,,Louisiana State,W (45-41),29,35,82.9,406,4,33,180,5.5,2,68,586,8.6,16,9,0,25,6,55,3,0,3,Missouri,/cfb/boxscores/2020-10-10-missouri.html
4.0,2020-10-24,,Kentucky,W (20-10),21,30,70.0,201,0,62,220,3.5,2,92,421,4.6,12,13,1,26,6,54,0,0,0,Missouri,/cfb/boxscores/2020-10-24-missouri.html
5.0,2020-10-31,@,Florida,L (17-41),26,40,65.0,208,0,23,40,1.7,1,63,248,3.9,11,3,2,16,9,62,2,0,2,Missouri,/cfb/boxscores/2020-10-31-florida.html
6.0,2020-11-21,@,South Carolina,W (17-10),21,33,63.6,203,1,34,98,2.9,1,67,301,4.5,10,6,3,19,7,77,0,1,1,Missouri,/cfb/boxscores/2020-11-21-south-carolina.html
7.0,2020-11-28,,Vanderbilt,W (41-0),34,41,82.9,380,1,38,223,5.9,4,79,603,7.6,20,11,0,31,1,5,0,0,0,Missouri,/cfb/boxscores/2020-11-28-missouri.html
8.0,2020-12-05,,Arkansas,W (50-48),32,49,65.3,380,0,38,273,7.2,5,87,653,7.5,20,12,5,37,8,57,0,0,0,Missouri,/cfb/boxscores/2020-12-05-missouri.html
9.0,2020-12-12,,Georgia,L (14-49),20,32,62.5,178,0,22,22,1.0,2,54,200,3.7,7,3,1,11,4,30,0,1,1,Missouri,/cfb/boxscores/2020-12-12-missouri.html
10.0,2020-12-19,@,Mississippi State,L (32-51),23,39,59.0,241,2,30,101,3.4,2,69,342,5.0,14,4,5,23,8,89,1,3,4,Missouri,/cfb/boxscores/2020-12-19-mississippi-state.html
1.0,2020-09-07,,Brigham Young,L (3-55),4,8,50.0,30,0,38,120,3.2,0,46,150,3.3,1,6,0,7,6,54,1,0,1,Navy,/cfb/boxscores/2020-09-07-navy.html
2.0,2020-09-19,@,Tulane,W (27-24),7,12,58.3,146,1,56,204,3.6,2,68,350,5.1,6,11,0,17,3,45,0,0,0,Navy,/cfb/boxscores/2020-09-19-tulane.html
3.0,2020-10-03,@,Air Force,L (7-40),8,18,44.4,151,1,36,90,2.5,0,54,241,4.5,3,6,1,10,4,30,1,1,2,Navy,/cfb/boxscores/2020-10-03-air-force.html
4.0,2020-10-10,,Temple,W (31-29),2,2,100.0,48,0,60,251,4.2,4,62,299,4.8,2,15,1,18,4,50,0,0,0,Navy,/cfb/boxscores/2020-10-10-navy.html
5.0,2020-10-17,@,East Carolina,W (27-23),3,5,60.0,30,0,57,288,5.1,4,62,318,5.1,2,15,0,17,3,24,1,1,2,Navy,/cfb/boxscores/2020-10-17-east-carolina.html
6.0,2020-10-24,,Houston,L (21-37),10,18,55.6,206,2,50,166,3.3,1,68,372,5.5,5,10,1,16,6,55,0,1,1,Navy,/cfb/boxscores/2020-10-24-navy.html
7.0,2020-10-31,@,Southern Methodist,L (37-51),14,30,46.7,239,2,45,191,4.2,3,75,430,5.7,12,12,3,27,4,30,1,0,1,Navy,/cfb/boxscores/2020-10-31-southern-methodist.html
8.0,2020-11-28,,Memphis,L (7-10),4,13,30.8,88,0,52,233,4.5,1,65,321,4.9,3,11,0,14,2,15,1,1,2,Navy,/cfb/boxscores/2020-11-28-navy.html
9.0,2020-12-05,,Tulsa,L (6-19),4,11,36.4,27,0,53,126,2.4,0,64,153,2.4,2,10,1,13,6,46,1,0,1,Navy,/cfb/boxscores/2020-12-05-navy.html
10.0,2020-12-12,@,Army,L (0-15),1,7,14.3,9,0,35,108,3.1,0,42,117,2.8,0,4,0,4,6,53,1,0,1,Navy,/cfb/boxscores/2020-12-12-army.html
1.0,2020-10-24,@,Ohio State,L (17-52),16,20,80.0,160,0,36,210,5.8,2,56,370,6.6,6,11,0,17,8,90,2,0,2,Nebraska,/cfb/boxscores/2020-10-24-ohio-state.html
2.0,2020-11-07,@,Northwestern,L (13-21),24,45,53.3,218,0,43,224,5.2,1,88,442,5.0,10,14,4,28,9,55,0,2,2,Nebraska,/cfb/boxscores/2020-11-07-northwestern.html
3.0,2020-11-14,,Penn State,W (30-23),13,21,61.9,152,1,39,146,3.7,1,60,298,5.0,6,9,2,17,5,39,0,1,1,Nebraska,/cfb/boxscores/2020-11-14-nebraska.html
4.0,2020-11-21,,Illinois,L (23-41),18,30,60.0,177,1,44,215,4.9,2,74,392,5.3,10,14,1,25,7,66,2,3,5,Nebraska,/cfb/boxscores/2020-11-21-nebraska.html
5.0,2020-11-27,@,Iowa,L (20-26),21,25,84.0,195,0,38,143,3.8,2,63,338,5.4,8,12,0,20,4,40,2,0,2,Nebraska,/cfb/boxscores/2020-11-27-iowa.html
6.0,2020-12-05,@,Purdue,W (37-27),24,31,77.4,253,1,40,111,2.8,3,71,364,5.1,12,5,3,20,9,107,0,0,0,Nebraska,/cfb/boxscores/2020-12-05-purdue.html
7.0,2020-12-12,,Minnesota,L (17-24),16,29,55.2,111,1,36,197,5.5,1,65,308,4.7,4,11,2,17,3,32,1,1,2,Nebraska,/cfb/boxscores/2020-12-12-nebraska.html
8.0,2020-12-18,@,Rutgers,W (28-21),24,28,85.7,255,1,58,365,6.3,3,86,620,7.2,12,15,0,27,9,56,2,2,4,Nebraska,/cfb/boxscores/2020-12-18-rutgers.html
1.0,2020-10-24,,Wyoming,W (37-34),39,52,75.0,420,4,27,76,2.8,1,79,496,6.3,18,6,1,25,12,101,2,0,2,Nevada,/cfb/boxscores/2020-10-24-nevada.html
2.0,2020-10-31,@,Nevada-Las Vegas,W (37-19),21,27,77.8,350,2,27,147,5.4,2,54,497,9.2,12,9,1,22,6,55,0,0,0,Nevada,/cfb/boxscores/2020-10-31-nevada-las-vegas.html
3.0,2020-11-05,,Utah State,W (34-9),37,54,68.5,421,3,28,121,4.3,1,82,542,6.6,19,6,2,27,10,74,0,0,0,Nevada,/cfb/boxscores/2020-11-05-nevada.html
4.0,2020-11-14,N,New Mexico,W (27-20),25,39,64.1,340,3,23,52,2.3,0,62,392,6.3,13,4,2,19,7,65,0,1,1,Nevada,/cfb/boxscores/2020-11-14-new-mexico.html
5.0,2020-11-21,,San Diego State,W (26-21),31,47,66.0,288,2,23,88,3.8,0,70,376,5.4,10,5,4,19,7,42,0,1,1,Nevada,/cfb/boxscores/2020-11-21-nevada.html
6.0,2020-11-28,@,Hawaii,L (21-24),20,25,80.0,168,2,36,208,5.8,1,61,376,6.2,10,12,1,23,8,79,0,0,0,Nevada,/cfb/boxscores/2020-11-28-hawaii.html
7.0,2020-12-05,,Fresno State,W (37-26),23,39,59.0,354,5,22,62,2.8,0,61,416,6.8,10,3,1,14,5,47,1,2,3,Nevada,/cfb/boxscores/2020-12-05-nevada.html
8.0,2020-12-11,N,San Jose State,L (20-30),33,48,68.8,260,1,26,138,5.3,1,74,398,5.4,14,7,3,24,7,62,2,0,2,Nevada,/cfb/boxscores/2020-12-11-san-jose-state.html
9.0,2020-12-22,N,Tulane*,W (38-27),22,28,78.6,271,5,44,209,4.8,1,72,480,6.7,9,10,2,21,10,100,0,0,0,Nevada,/cfb/boxscores/2020-12-22-nevada.html
1.0,2020-10-24,@,San Diego State,L (6-34),17,29,58.6,106,1,35,80,2.3,0,64,186,2.9,4,7,0,11,6,40,1,0,1,Nevada-Las Vegas,/cfb/boxscores/2020-10-24-san-diego-state.html
2.0,2020-10-31,,Nevada,L (19-37),28,41,68.3,222,2,32,126,3.9,0,73,348,4.8,12,9,1,22,10,77,0,0,0,Nevada-Las Vegas,/cfb/boxscores/2020-10-31-nevada-las-vegas.html
3.0,2020-11-07,,Fresno State,L (27-40),15,31,48.4,160,1,46,242,5.3,2,77,402,5.2,8,11,0,19,5,40,1,2,3,Nevada-Las Vegas,/cfb/boxscores/2020-11-07-nevada-las-vegas.html
4.0,2020-11-14,@,San Jose State,L (17-34),19,28,67.9,224,1,36,70,1.9,1,64,294,4.6,9,7,0,16,8,84,0,0,0,Nevada-Las Vegas,/cfb/boxscores/2020-11-14-san-jose-state.html
5.0,2020-11-27,,Wyoming,L (14-45),15,27,55.6,158,0,35,132,3.8,2,62,290,4.7,7,9,3,19,3,20,1,1,2,Nevada-Las Vegas,/cfb/boxscores/2020-11-27-nevada-las-vegas.html
6.0,2020-12-12,@,Hawaii,L (21-38),21,40,52.5,245,1,40,218,5.5,2,80,463,5.8,13,11,2,26,7,63,2,1,3,Nevada-Las Vegas,/cfb/boxscores/2020-12-12-hawaii.html
1.0,2020-10-31,@,San Jose State,L (21-38),20,35,57.1,294,2,40,149,3.7,1,75,443,5.9,14,7,2,23,4,40,0,1,1,New Mexico,/cfb/boxscores/2020-10-31-san-jose-state.html
2.0,2020-11-07,@,Hawaii,L (33-39),19,37,51.4,220,2,38,279,7.3,1,75,499,6.7,9,13,2,24,7,57,0,1,1,New Mexico,/cfb/boxscores/2020-11-07-hawaii.html
3.0,2020-11-14,N,Nevada,L (20-27),18,33,54.5,211,1,44,141,3.2,1,77,352,4.6,9,11,1,21,2,30,0,1,1,New Mexico,/cfb/boxscores/2020-11-14-new-mexico.html
4.0,2020-11-20,@,Air Force,L (0-28),23,42,54.8,221,0,25,83,3.3,0,67,304,4.5,12,6,1,19,8,70,1,1,2,New Mexico,/cfb/boxscores/2020-11-20-air-force.html
5.0,2020-11-26,@,Utah State,L (27-41),17,32,53.1,152,1,44,196,4.5,2,76,348,4.6,9,9,7,25,8,84,1,1,2,New Mexico,/cfb/boxscores/2020-11-26-utah-state.html
6.0,2020-12-05,,Wyoming,W (17-16),11,18,61.1,92,1,50,223,4.5,1,68,315,4.6,4,11,1,16,5,50,1,1,2,New Mexico,/cfb/boxscores/2020-12-05-new-mexico.html
7.0,2020-12-12,N,Fresno State,W (49-39),14,18,77.8,196,1,48,299,6.2,6,66,495,7.5,7,14,3,24,8,73,0,0,0,New Mexico,/cfb/boxscores/2020-12-12-new-mexico.html
1.0,2021-02-21,,Tarleton State,L (17-43),17,31,54.8,187,1,27,96,3.6,0,58,283,4.9,6,14,1,21,12,121,0,3,3,New Mexico State,/cfb/boxscores/2021-02-21-new-mexico-state.html
2.0,2021-03-07,N,Utah Tech,W (36-29),25,37,67.6,232,1,51,329,6.5,3,88,561,6.4,12,19,2,33,7,41,0,0,0,New Mexico State,/cfb/boxscores/2021-03-07-new-mexico-state.html
1.0,2020-09-12,,Syracuse,W (31-6),26,35,74.3,303,1,35,160,4.6,3,70,463,6.6,14,7,2,23,9,91,1,2,3,North Carolina,/cfb/boxscores/2020-09-12-north-carolina.html
2.0,2020-10-03,@,Boston College,W (26-22),14,26,53.8,225,2,39,176,4.5,1,65,401,6.2,11,9,4,24,10,96,0,1,1,North Carolina,/cfb/boxscores/2020-10-03-boston-college.html
3.0,2020-10-10,,Virginia Tech,W (56-45),18,23,78.3,257,3,43,399,9.3,5,66,656,9.9,12,18,1,31,10,87,0,0,0,North Carolina,/cfb/boxscores/2020-10-10-north-carolina.html
4.0,2020-10-17,@,Florida State,L (28-31),20,36,55.6,374,3,45,184,4.1,1,81,558,6.9,14,9,4,27,7,50,0,1,1,North Carolina,/cfb/boxscores/2020-10-17-florida-state.html
5.0,2020-10-24,,North Carolina State,W (48-21),18,29,62.1,252,1,55,326,5.9,5,84,578,6.9,13,19,2,34,9,70,0,0,0,North Carolina,/cfb/boxscores/2020-10-24-north-carolina.html
6.0,2020-10-31,@,Virginia,L (41-44),23,28,82.1,443,4,33,93,2.8,1,61,536,8.8,15,7,2,24,6,69,2,0,2,North Carolina,/cfb/boxscores/2020-10-31-virginia.html
7.0,2020-11-07,@,Duke,W (56-24),19,28,67.9,235,3,47,338,7.2,5,75,573,7.6,13,16,1,30,6,80,0,1,1,North Carolina,/cfb/boxscores/2020-11-07-duke.html
8.0,2020-11-14,,Wake Forest,W (59-53),32,45,71.1,550,6,38,192,5.1,2,83,742,8.9,17,12,1,30,6,58,0,1,1,North Carolina,/cfb/boxscores/2020-11-14-north-carolina.html
9.0,2020-11-27,,Notre Dame,L (17-31),17,27,63.0,211,1,30,87,2.9,1,57,298,5.2,9,4,1,14,9,90,0,0,0,North Carolina,/cfb/boxscores/2020-11-27-north-carolina.html
10.0,2020-12-05,,Western Carolina,W (49-9),24,29,82.8,309,2,38,231,6.1,5,67,540,8.1,16,14,1,31,3,35,2,1,3,North Carolina,/cfb/boxscores/2020-12-05-north-carolina.html
11.0,2020-12-12,@,Miami (FL),W (62-26),15,20,75.0,224,2,55,554,10.1,6,75,778,10.4,7,22,2,31,5,50,0,0,0,North Carolina,/cfb/boxscores/2020-12-12-miami-fl.html
12.0,2021-01-02,N,Texas A&M*,L (27-41),18,31,58.1,234,3,34,90,2.6,0,65,324,5.0,9,6,3,18,5,38,0,1,1,North Carolina,/cfb/boxscores/2021-01-02-north-carolina.html
1.0,2020-09-19,,Wake Forest,W (45-42),17,24,70.8,193,2,49,270,5.5,4,73,463,6.3,10,14,0,24,6,65,0,1,1,North Carolina State,/cfb/boxscores/2020-09-19-north-carolina-state.html
2.0,2020-09-26,@,Virginia Tech,L (24-45),19,33,57.6,247,1,42,139,3.3,2,75,386,5.1,10,9,0,19,8,65,0,2,2,North Carolina State,/cfb/boxscores/2020-09-26-virginia-tech.html
3.0,2020-10-03,@,Pittsburgh,W (30-29),28,45,62.2,336,4,30,62,2.1,0,75,398,5.3,14,6,8,28,11,80,0,0,0,North Carolina State,/cfb/boxscores/2020-10-03-pittsburgh.html
4.0,2020-10-10,@,Virginia,W (38-21),11,25,44.0,184,2,42,179,4.3,2,67,363,5.4,9,7,1,17,11,100,0,1,1,North Carolina State,/cfb/boxscores/2020-10-10-virginia.html
5.0,2020-10-17,,Duke,W (31-20),19,33,57.6,248,2,35,117,3.3,1,68,365,5.4,11,6,2,19,8,106,2,1,3,North Carolina State,/cfb/boxscores/2020-10-17-north-carolina-state.html
6.0,2020-10-24,@,North Carolina,L (21-48),27,44,61.4,358,2,19,34,1.8,1,63,392,6.2,16,3,4,23,5,41,1,3,4,North Carolina State,/cfb/boxscores/2020-10-24-north-carolina.html
7.0,2020-11-06,,Miami (FL),L (41-44),20,29,69.0,279,3,34,131,3.9,1,63,410,6.5,15,6,3,24,8,78,0,1,1,North Carolina State,/cfb/boxscores/2020-11-06-north-carolina-state.html
8.0,2020-11-14,,Florida State,W (38-22),24,34,70.6,265,3,39,148,3.8,2,73,413,5.7,13,8,3,24,6,70,0,1,1,North Carolina State,/cfb/boxscores/2020-11-14-north-carolina-state.html
9.0,2020-11-21,,Liberty,W (15-14),14,27,51.9,154,0,39,167,4.3,2,66,321,4.9,5,14,0,19,14,123,0,1,1,North Carolina State,/cfb/boxscores/2020-11-21-north-carolina-state.html
10.0,2020-11-28,@,Syracuse,W (36-29),23,31,74.2,313,4,44,95,2.2,1,75,408,5.4,13,9,5,27,5,40,1,1,2,North Carolina State,/cfb/boxscores/2020-11-28-syracuse.html
11.0,2020-12-05,,Georgia Tech,W (23-13),23,36,63.9,309,0,32,88,2.8,2,68,397,5.8,16,4,4,24,7,78,0,0,0,North Carolina State,/cfb/boxscores/2020-12-05-north-carolina-state.html
12.0,2021-01-02,N,Kentucky*,L (21-23),27,40,67.5,268,1,26,50,1.9,2,66,318,4.8,14,4,1,19,7,45,0,3,3,North Carolina State,/cfb/boxscores/2021-01-02-kentucky.html
1.0,2020-09-05,,Houston Christian,W (57-31),21,34,61.8,361,4,52,360,6.9,4,86,721,8.4,15,15,3,33,6,48,0,1,1,North Texas,/cfb/boxscores/2020-09-05-north-texas.html
2.0,2020-09-19,,Southern Methodist,L (35-65),17,34,50.0,305,3,53,212,4.0,2,87,517,5.9,12,13,0,25,13,97,1,1,2,North Texas,/cfb/boxscores/2020-09-19-north-texas.html
3.0,2020-10-03,,Southern Mississippi,L (31-41),28,47,59.6,339,2,38,144,3.8,2,85,483,5.7,19,8,0,27,2,20,3,0,3,North Texas,/cfb/boxscores/2020-10-03-north-texas.html
4.0,2020-10-10,,Charlotte,L (21-49),23,43,53.5,382,3,27,97,3.6,0,70,479,6.8,15,5,2,22,4,35,0,1,1,North Texas,/cfb/boxscores/2020-10-10-north-texas.html
5.0,2020-10-17,@,Middle Tennessee State,W (52-35),18,28,64.3,306,2,49,462,9.4,5,77,768,10.0,11,20,1,32,10,61,1,2,3,North Texas,/cfb/boxscores/2020-10-17-middle-tennessee-state.html
6.0,2020-11-21,,Rice,W (27-17),9,20,45.0,120,1,42,269,6.4,2,62,389,6.3,6,11,0,17,5,42,0,0,0,North Texas,/cfb/boxscores/2020-11-21-north-texas.html
7.0,2020-11-28,@,UTSA,L (17-49),14,33,42.4,217,2,39,184,4.7,0,72,401,5.6,6,12,1,19,3,20,0,2,2,North Texas,/cfb/boxscores/2020-11-28-texas-san-antonio.html
8.0,2020-12-03,,Louisiana Tech,L (31-42),17,30,56.7,231,3,41,155,3.8,1,71,386,5.4,10,8,1,19,11,82,0,1,1,North Texas,/cfb/boxscores/2020-12-03-north-texas.html
9.0,2020-12-11,@,UTEP,W (45-43),16,30,53.3,302,5,44,189,4.3,1,74,491,6.6,9,10,5,24,5,40,1,0,1,North Texas,/cfb/boxscores/2020-12-11-texas-el-paso.html
10.0,2020-12-21,N,Appalachian State*,L (28-56),22,37,59.5,267,3,58,230,4.0,1,95,497,5.2,14,15,1,30,9,91,0,1,1,North Texas,/cfb/boxscores/2020-12-21-north-texas.html
1.0,2020-11-04,,Buffalo,L (30-49),19,33,57.6,241,1,47,156,3.3,3,80,397,5.0,12,11,3,26,7,65,4,1,5,Northern Illinois,/cfb/boxscores/2020-11-04-northern-illinois.html
2.0,2020-11-11,,Central Michigan,L (10-40),17,34,50.0,170,1,33,74,2.2,0,67,244,3.6,8,3,2,13,5,45,2,0,2,Northern Illinois,/cfb/boxscores/2020-11-11-northern-illinois.html
3.0,2020-11-18,@,Ball State,L (25-31),27,41,65.9,300,1,32,112,3.5,2,73,412,5.6,15,7,2,24,7,67,0,1,1,Northern Illinois,/cfb/boxscores/2020-11-18-ball-state.html
4.0,2020-11-28,@,Western Michigan,L (27-30),23,37,62.2,238,3,43,112,2.6,0,80,350,4.4,8,8,2,18,8,90,0,0,0,Northern Illinois,/cfb/boxscores/2020-11-28-western-michigan.html
5.0,2020-12-05,,Toledo,L (24-41),19,39,48.7,273,2,28,109,3.9,1,67,382,5.7,12,5,4,21,8,77,1,0,1,Northern Illinois,/cfb/boxscores/2020-12-05-northern-illinois.html
6.0,2020-12-12,@,Eastern Michigan,L (33-41),22,37,59.5,221,3,38,199,5.2,1,75,420,5.6,11,10,4,25,6,63,1,0,1,Northern Illinois,/cfb/boxscores/2020-12-12-eastern-michigan.html
1.0,2020-10-24,,Maryland,W (43-3),23,30,76.7,212,1,53,325,6.1,4,83,537,6.5,13,17,1,31,5,48,0,0,0,Northwestern,/cfb/boxscores/2020-10-24-northwestern.html
2.0,2020-10-31,@,Iowa,W (21-20),11,18,61.1,130,0,60,143,2.4,3,78,273,3.5,8,9,1,18,6,45,2,1,3,Northwestern,/cfb/boxscores/2020-10-31-iowa.html
3.0,2020-11-07,,Nebraska,W (21-13),16,27,59.3,169,2,38,148,3.9,1,65,317,4.9,9,5,0,14,8,64,0,2,2,Northwestern,/cfb/boxscores/2020-11-07-northwestern.html
4.0,2020-11-14,@,Purdue,W (27-20),23,36,63.9,212,3,40,80,2.0,0,76,292,3.8,13,5,1,19,7,59,0,1,1,Northwestern,/cfb/boxscores/2020-11-14-purdue.html
5.0,2020-11-21,,Wisconsin,W (17-7),24,45,53.3,239,2,23,24,1.0,0,68,263,3.9,11,1,4,16,1,5,1,0,1,Northwestern,/cfb/boxscores/2020-11-21-northwestern.html
6.0,2020-11-28,@,Michigan State,L (20-29),22,44,50.0,222,0,37,63,1.7,2,81,285,3.5,13,4,1,18,3,20,2,2,4,Northwestern,/cfb/boxscores/2020-11-28-michigan-state.html
7.0,2020-12-12,,Illinois,W (28-10),7,12,58.3,82,1,58,411,7.1,3,70,493,7.0,5,16,2,23,6,40,1,0,1,Northwestern,/cfb/boxscores/2020-12-12-northwestern.html
8.0,2020-12-19,N,Ohio State,L (10-22),24,37,64.9,224,0,33,107,3.2,1,70,331,4.7,11,6,2,19,2,15,1,2,3,Northwestern,/cfb/boxscores/2020-12-19-ohio-state.html
9.0,2021-01-01,N,Auburn*,W (35-19),24,35,68.6,291,3,51,166,3.3,2,86,457,5.3,14,8,3,25,7,68,0,0,0,Northwestern,/cfb/boxscores/2021-01-01-northwestern.html
1.0,2020-09-12,,Duke,W (27-13),19,31,61.3,263,1,42,178,4.2,2,73,441,6.0,12,11,1,24,4,39,0,1,1,Notre Dame,/cfb/boxscores/2020-09-12-notre-dame.html
2.0,2020-09-19,,South Florida,W (52-0),13,21,61.9,149,0,45,281,6.2,6,66,430,6.5,5,16,0,21,2,25,0,0,0,Notre Dame,/cfb/boxscores/2020-09-19-notre-dame.html
3.0,2020-10-10,,Florida State,W (42-26),16,25,64.0,201,2,42,353,8.4,4,67,554,8.3,8,15,2,25,4,28,2,0,2,Notre Dame,/cfb/boxscores/2020-10-10-notre-dame.html
4.0,2020-10-17,,Louisville,W (12-7),11,19,57.9,106,0,49,232,4.7,1,68,338,5.0,8,14,2,24,3,18,0,0,0,Notre Dame,/cfb/boxscores/2020-10-17-notre-dame.html
5.0,2020-10-24,@,Pittsburgh,W (45-3),17,33,51.5,319,3,50,115,2.3,2,83,434,5.2,11,11,6,28,7,63,0,0,0,Notre Dame,/cfb/boxscores/2020-10-24-pittsburgh.html
6.0,2020-10-31,@,Georgia Tech,W (31-13),18,26,69.2,199,1,44,227,5.2,3,70,426,6.1,9,13,2,24,5,50,1,0,1,Notre Dame,/cfb/boxscores/2020-10-31-georgia-tech.html
7.0,2020-11-07,,Clemson,W (47-40),22,39,56.4,310,1,40,208,5.2,3,79,518,6.6,15,5,2,22,7,50,1,0,1,Notre Dame,/cfb/boxscores/2020-11-07-notre-dame.html
8.0,2020-11-14,@,Boston College,W (45-31),20,28,71.4,283,3,49,274,5.6,3,77,557,7.2,10,17,2,29,8,69,3,0,3,Notre Dame,/cfb/boxscores/2020-11-14-boston-college.html
9.0,2020-11-27,@,North Carolina,W (31-17),23,33,69.7,279,1,36,199,5.5,3,69,478,6.9,12,8,5,25,4,24,0,0,0,Notre Dame,/cfb/boxscores/2020-11-27-north-carolina.html
10.0,2020-12-05,,Syracuse,W (45-21),24,37,64.9,285,3,40,283,7.1,3,77,568,7.4,15,9,2,26,4,40,1,1,2,Notre Dame,/cfb/boxscores/2020-12-05-notre-dame.html
11.0,2020-12-19,N,Clemson,L (10-34),20,28,71.4,219,0,30,44,1.5,1,58,263,4.5,12,3,3,18,2,25,0,0,0,Notre Dame,/cfb/boxscores/2020-12-19-notre-dame.html
12.0,2021-01-01,N,Alabama*,L (14-31),28,42,66.7,236,0,38,139,3.7,2,80,375,4.7,13,8,3,24,3,25,0,1,1,Notre Dame,/cfb/boxscores/2021-01-01-alabama.html
1.0,2020-11-04,@,Central Michigan,L (27-30),13,22,59.1,235,2,36,110,3.1,1,58,345,5.9,7,6,3,16,11,74,2,0,2,Ohio,/cfb/boxscores/2020-11-04-central-michigan.html
2.0,2020-11-10,,Akron,W (24-10),10,17,58.8,122,0,33,185,5.6,3,50,307,6.1,4,9,2,15,4,30,0,0,0,Ohio,/cfb/boxscores/2020-11-10-ohio.html
3.0,2020-11-28,,Bowling Green State,W (52-10),13,15,86.7,81,2,48,355,7.4,4,63,436,6.9,4,15,2,21,5,40,0,0,0,Ohio,/cfb/boxscores/2020-11-28-ohio.html
1.0,2020-10-24,,Nebraska,W (52-17),20,21,95.2,276,2,48,215,4.5,4,69,491,7.1,12,13,3,28,3,14,1,0,1,Ohio State,/cfb/boxscores/2020-10-24-ohio-state.html
2.0,2020-10-31,@,Penn State,W (38-25),28,34,82.4,318,4,45,208,4.6,1,79,526,6.7,12,10,2,24,9,80,0,0,0,Ohio State,/cfb/boxscores/2020-10-31-penn-state.html
3.0,2020-11-07,,Rutgers,W (49-27),24,28,85.7,314,5,37,203,5.5,2,65,517,8.0,13,8,4,25,9,74,1,0,1,Ohio State,/cfb/boxscores/2020-11-07-ohio-state.html
4.0,2020-11-21,,Indiana,W (42-35),18,30,60.0,300,2,50,307,6.1,3,80,607,7.6,13,13,1,27,3,35,0,3,3,Ohio State,/cfb/boxscores/2020-11-21-ohio-state.html
5.0,2020-12-05,@,Michigan State,W (52-12),17,24,70.8,199,2,48,322,6.7,4,72,521,7.2,9,12,5,26,7,63,1,0,1,Ohio State,/cfb/boxscores/2020-12-05-michigan-state.html
6.0,2020-12-19,N,Northwestern,W (22-10),12,27,44.4,114,0,44,399,9.1,2,71,513,7.2,6,17,1,24,5,45,0,2,2,Ohio State,/cfb/boxscores/2020-12-19-ohio-state.html
7.0,2021-01-01,N,Clemson*,W (49-28),22,28,78.6,385,6,44,254,5.8,1,72,639,8.9,15,10,1,26,9,95,0,1,1,Ohio State,/cfb/boxscores/2021-01-01-clemson.html
8.0,2021-01-11,N,Alabama*,L (24-52),17,33,51.5,194,1,29,147,5.1,2,62,341,5.5,11,5,3,19,4,29,0,0,0,Ohio State,/cfb/boxscores/2021-01-11-alabama.html
1.0,2020-09-12,,Missouri State,W (48-0),30,36,83.3,484,5,35,124,3.5,1,71,608,8.6,19,7,1,27,9,75,0,1,1,Oklahoma,/cfb/boxscores/2020-09-12-oklahoma.html
2.0,2020-09-26,,Kansas State,L (35-38),30,41,73.2,387,4,35,130,3.7,1,76,517,6.8,17,8,3,28,10,75,1,3,4,Oklahoma,/cfb/boxscores/2020-09-26-oklahoma.html
3.0,2020-10-03,@,Iowa State,L (30-37),25,36,69.4,300,2,33,114,3.5,1,69,414,6.0,14,5,3,22,9,93,0,1,1,Oklahoma,/cfb/boxscores/2020-10-03-iowa-state.html
4.0,2020-10-10,N,Texas,W (53-45),28,42,66.7,261,3,55,208,3.8,4,97,469,4.8,18,10,2,30,10,106,2,1,3,Oklahoma,/cfb/boxscores/2020-10-10-oklahoma.html
5.0,2020-10-24,@,TCU,W (33-14),13,22,59.1,332,2,45,166,3.7,1,67,498,7.4,10,11,2,23,7,65,0,0,0,Oklahoma,/cfb/boxscores/2020-10-24-texas-christian.html
6.0,2020-10-31,@,Texas Tech,W (62-28),27,38,71.1,346,2,39,213,5.5,6,77,559,7.3,16,9,4,29,2,15,0,0,0,Oklahoma,/cfb/boxscores/2020-10-31-texas-tech.html
7.0,2020-11-07,,Kansas,W (62-9),22,36,61.1,340,2,31,200,6.5,6,67,540,8.1,17,13,1,31,5,45,1,1,2,Oklahoma,/cfb/boxscores/2020-11-07-oklahoma.html
8.0,2020-11-21,,Oklahoma State,W (41-13),17,24,70.8,301,4,44,191,4.3,1,68,492,7.2,12,9,2,23,7,87,0,0,0,Oklahoma,/cfb/boxscores/2020-11-21-oklahoma.html
9.0,2020-12-05,,Baylor,W (27-14),20,28,71.4,193,2,31,76,2.5,1,59,269,4.6,11,3,2,16,8,62,0,1,1,Oklahoma,/cfb/boxscores/2020-12-05-oklahoma.html
10.0,2020-12-19,N,Iowa State,W (27-21),22,34,64.7,272,1,31,120,3.9,2,65,392,6.0,13,6,1,20,8,60,0,0,0,Oklahoma,/cfb/boxscores/2020-12-19-iowa-state.html
11.0,2020-12-30,N,Florida*,W (55-20),15,25,60.0,249,3,40,435,10.9,3,65,684,10.5,9,15,1,25,4,40,2,0,2,Oklahoma,/cfb/boxscores/2020-12-30-oklahoma.html
1.0,2020-09-19,,Tulsa,W (16-7),14,20,70.0,143,0,48,149,3.1,1,68,292,4.3,6,10,2,18,8,68,1,1,2,Oklahoma State,/cfb/boxscores/2020-09-19-oklahoma-state.html
2.0,2020-09-26,,West Virginia,W (27-13),15,22,68.2,139,0,41,203,5.0,2,63,342,5.4,7,10,3,20,7,65,0,1,1,Oklahoma State,/cfb/boxscores/2020-09-26-oklahoma-state.html
3.0,2020-10-03,@,Kansas,W (47-7),20,30,66.7,298,3,60,295,4.9,2,90,593,6.6,10,20,1,31,5,35,0,0,0,Oklahoma State,/cfb/boxscores/2020-10-03-kansas.html
4.0,2020-10-24,,Iowa State,W (24-21),20,29,69.0,235,1,51,226,4.4,2,80,461,5.8,13,10,1,24,10,73,0,2,2,Oklahoma State,/cfb/boxscores/2020-10-24-oklahoma-state.html
5.0,2020-10-31,,Texas,L (34-41),27,40,67.5,400,4,51,130,2.5,0,91,530,5.8,19,8,5,32,8,70,3,1,4,Oklahoma State,/cfb/boxscores/2020-10-31-oklahoma-state.html
6.0,2020-11-07,@,Kansas State,W (20-18),14,23,60.9,108,0,40,148,3.7,1,63,256,4.1,5,8,1,14,6,65,0,0,0,Oklahoma State,/cfb/boxscores/2020-11-07-kansas-state.html
7.0,2020-11-21,@,Oklahoma,L (13-41),15,40,37.5,168,1,28,78,2.8,0,68,246,3.6,8,4,7,19,8,41,0,1,1,Oklahoma State,/cfb/boxscores/2020-11-21-oklahoma.html
8.0,2020-11-28,,Texas Tech,W (50-44),19,31,61.3,222,1,57,317,5.6,4,88,539,6.1,9,17,4,30,3,20,2,1,3,Oklahoma State,/cfb/boxscores/2020-11-28-oklahoma-state.html
9.0,2020-12-05,@,TCU,L (22-29),16,36,44.4,270,1,40,148,3.7,1,76,418,5.5,10,5,1,16,5,50,0,1,1,Oklahoma State,/cfb/boxscores/2020-12-05-texas-christian.html
10.0,2020-12-12,@,Baylor,W (42-3),20,30,66.7,347,3,47,261,5.6,3,77,608,7.9,12,15,0,27,4,25,0,2,2,Oklahoma State,/cfb/boxscores/2020-12-12-baylor.html
11.0,2020-12-29,N,Miami (FL)*,W (37-34),27,40,67.5,305,4,43,113,2.6,1,83,418,5.0,17,7,5,29,9,81,0,0,0,Oklahoma State,/cfb/boxscores/2020-12-29-miami-fl.html
1.0,2020-09-26,,Florida,L (35-51),24,33,72.7,443,3,45,170,3.8,2,78,613,7.9,15,13,1,29,4,45,0,1,1,Ole Miss,/cfb/boxscores/2020-09-26-mississippi.html
2.0,2020-10-03,@,Kentucky,W (42-41),24,29,82.8,320,4,38,139,3.7,2,67,459,6.9,14,7,5,26,5,33,0,0,0,Ole Miss,/cfb/boxscores/2020-10-03-kentucky.html
3.0,2020-10-10,,Alabama,L (48-63),22,29,75.9,379,2,57,268,4.7,4,86,647,7.5,16,12,3,31,6,67,0,0,0,Ole Miss,/cfb/boxscores/2020-10-10-mississippi.html
4.0,2020-10-17,@,Arkansas,L (21-33),20,38,52.6,200,2,53,242,4.6,1,91,442,4.9,10,13,0,23,6,35,1,6,7,Ole Miss,/cfb/boxscores/2020-10-17-arkansas.html
5.0,2020-10-24,,Auburn,L (28-35),17,28,60.7,161,1,51,283,5.5,3,79,444,5.6,8,16,1,25,1,5,0,2,2,Ole Miss,/cfb/boxscores/2020-10-24-mississippi.html
6.0,2020-10-31,@,Vanderbilt,W (54-21),32,37,86.5,449,7,42,196,4.7,1,79,645,8.2,19,14,2,35,8,75,1,0,1,Ole Miss,/cfb/boxscores/2020-10-31-vanderbilt.html
7.0,2020-11-14,,South Carolina,W (59-42),28,32,87.5,513,4,48,195,4.1,4,80,708,8.9,14,14,3,31,6,45,1,0,1,Ole Miss,/cfb/boxscores/2020-11-14-mississippi.html
8.0,2020-11-28,,Mississippi State,W (31-24),25,37,67.6,387,2,45,163,3.6,2,82,550,6.7,14,9,1,24,10,81,0,0,0,Ole Miss,/cfb/boxscores/2020-11-28-mississippi.html
9.0,2020-12-19,@,Louisiana State,L (48-53),15,27,55.6,251,3,48,307,6.4,3,75,558,7.4,9,16,0,25,6,51,1,5,6,Ole Miss,/cfb/boxscores/2020-12-19-louisiana-state.html
10.0,2021-01-02,N,Indiana*,W (26-20),31,45,68.9,346,2,35,147,4.2,1,80,493,6.2,18,8,1,27,8,79,0,0,0,Ole Miss,/cfb/boxscores/2021-01-02-indiana.html
1.0,2020-11-07,,Stanford,W (35-14),17,26,65.4,227,1,40,269,6.7,4,66,496,7.5,10,15,4,29,6,43,1,1,2,Oregon,/cfb/boxscores/2020-11-07-oregon.html
2.0,2020-11-14,@,Washington State,W (43-29),21,30,70.0,312,4,36,269,7.5,2,66,581,8.8,13,12,1,26,4,37,2,1,3,Oregon,/cfb/boxscores/2020-11-14-washington-state.html
3.0,2020-11-21,,UCLA,W (38-35),19,30,63.3,334,3,34,88,2.6,1,64,422,6.6,15,6,0,21,7,65,1,0,1,Oregon,/cfb/boxscores/2020-11-21-oregon.html
4.0,2020-11-27,@,Oregon State,L (38-41),20,32,62.5,285,2,34,183,5.4,3,66,468,7.1,10,11,2,23,7,51,1,2,3,Oregon,/cfb/boxscores/2020-11-27-oregon-state.html
5.0,2020-12-05,@,California,L (17-21),14,26,53.8,231,1,34,137,4.0,1,60,368,6.1,9,8,2,19,9,60,2,0,2,Oregon,/cfb/boxscores/2020-12-05-california.html
6.0,2020-12-18,@,Southern California,W (31-24),11,19,57.9,108,4,41,135,3.3,0,60,243,4.1,6,8,2,16,5,70,0,1,1,Oregon,/cfb/boxscores/2020-12-18-southern-california.html
7.0,2021-01-02,N,Iowa State*,L (17-34),19,28,67.9,226,0,18,86,4.8,2,46,312,6.8,13,4,0,17,3,30,3,1,4,Oregon,/cfb/boxscores/2021-01-02-iowa-state.html
1.0,2020-11-07,,Washington State,L (28-38),34,49,69.4,329,1,31,122,3.9,3,80,451,5.6,18,9,2,29,4,45,0,0,0,Oregon State,/cfb/boxscores/2020-11-07-oregon-state.html
2.0,2020-11-14,@,Washington,L (21-27),11,24,45.8,85,0,34,167,4.9,2,58,252,4.3,5,11,0,16,6,55,1,1,2,Oregon State,/cfb/boxscores/2020-11-14-washington.html
3.0,2020-11-21,,California,W (31-27),13,21,61.9,155,2,30,205,6.8,2,51,360,7.1,9,6,1,16,6,47,0,2,2,Oregon State,/cfb/boxscores/2020-11-21-oregon-state.html
4.0,2020-11-27,,Oregon,W (41-38),23,38,60.5,263,1,44,269,6.1,4,82,532,6.5,15,10,0,25,7,62,0,0,0,Oregon State,/cfb/boxscores/2020-11-27-oregon-state.html
5.0,2020-12-05,@,Utah,L (24-30),20,38,52.6,202,1,31,133,4.3,2,69,335,4.9,8,7,7,22,5,35,0,1,1,Oregon State,/cfb/boxscores/2020-12-05-utah.html
6.0,2020-12-12,,Stanford,L (24-27),17,30,56.7,221,3,39,237,6.1,0,69,458,6.6,9,13,0,22,6,53,1,0,1,Oregon State,/cfb/boxscores/2020-12-12-oregon-state.html
7.0,2020-12-19,,Arizona State,L (33-46),16,33,48.5,224,3,49,250,5.1,2,82,474,5.8,11,14,0,25,8,57,1,1,2,Oregon State,/cfb/boxscores/2020-12-19-oregon-state.html
1.0,2020-10-24,@,Indiana,L (35-36),24,35,68.6,238,3,52,250,4.8,2,87,488,5.6,12,13,2,27,10,100,1,2,3,Penn State,/cfb/boxscores/2020-10-24-indiana.html
2.0,2020-10-31,,Ohio State,L (25-38),18,30,60.0,281,3,27,44,1.6,0,57,325,5.7,13,4,3,20,5,31,0,1,1,Penn State,/cfb/boxscores/2020-10-31-penn-state.html
3.0,2020-11-07,,Maryland,L (19-35),27,57,47.4,340,3,36,94,2.6,0,93,434,4.7,19,8,3,30,4,25,1,2,3,Penn State,/cfb/boxscores/2020-11-07-penn-state.html
4.0,2020-11-14,@,Nebraska,L (23-30),19,39,48.7,256,0,52,245,4.7,2,91,501,5.5,12,16,2,30,4,50,1,1,2,Penn State,/cfb/boxscores/2020-11-14-nebraska.html
5.0,2020-11-21,,Iowa,L (21-41),26,38,68.4,280,2,35,62,1.8,1,73,342,4.7,13,6,0,19,2,15,2,2,4,Penn State,/cfb/boxscores/2020-11-21-penn-state.html
6.0,2020-11-28,@,Michigan,W (27-17),17,29,58.6,163,0,50,254,5.1,3,79,417,5.3,10,15,0,25,5,30,0,0,0,Penn State,/cfb/boxscores/2020-11-28-michigan.html
7.0,2020-12-05,@,Rutgers,W (23-7),15,22,68.2,133,1,57,248,4.4,1,79,381,4.8,7,14,2,23,2,20,1,1,2,Penn State,/cfb/boxscores/2020-12-05-rutgers.html
8.0,2020-12-12,,Michigan State,W (39-24),20,30,66.7,286,2,40,119,3.0,2,70,405,5.8,12,7,2,21,5,45,1,0,1,Penn State,/cfb/boxscores/2020-12-12-penn-state.html
9.0,2020-12-19,,Illinois,W (56-21),19,27,70.4,327,3,53,253,4.8,4,80,580,7.3,11,16,1,28,2,19,1,0,1,Penn State,/cfb/boxscores/2020-12-19-penn-state.html
1.0,2020-09-12,,Austin Peay,W (55-0),19,28,67.9,309,1,34,149,4.4,6,62,458,7.4,10,9,1,20,4,30,0,0,0,Pitt,/cfb/boxscores/2020-09-12-pittsburgh.html
2.0,2020-09-19,,Syracuse,W (21-10),25,36,69.4,215,2,44,127,2.9,1,80,342,4.3,11,8,4,23,7,70,1,1,2,Pitt,/cfb/boxscores/2020-09-19-pittsburgh.html
3.0,2020-09-26,,Louisville,W (23-20),23,38,60.5,220,2,40,156,3.9,0,78,376,4.8,10,10,0,20,6,46,1,1,2,Pitt,/cfb/boxscores/2020-09-26-pittsburgh.html
4.0,2020-10-03,,North Carolina State,L (29-30),22,40,55.0,411,1,37,92,2.5,2,77,503,6.5,15,6,3,24,13,125,0,0,0,Pitt,/cfb/boxscores/2020-10-03-pittsburgh.html
5.0,2020-10-10,@,Boston College,L (30-31),24,47,51.1,266,2,40,98,2.5,2,87,364,4.2,12,7,5,24,6,46,0,1,1,Pitt,/cfb/boxscores/2020-10-10-boston-college.html
6.0,2020-10-17,@,Miami (FL),L (19-31),23,47,48.9,278,1,26,22,0.8,0,73,300,4.1,13,2,4,19,10,89,1,0,1,Pitt,/cfb/boxscores/2020-10-17-miami-fl.html
7.0,2020-10-24,,Notre Dame,L (3-45),12,33,36.4,118,0,20,44,2.2,0,53,162,3.1,5,3,3,11,12,93,0,3,3,Pitt,/cfb/boxscores/2020-10-24-pittsburgh.html
8.0,2020-11-07,@,Florida State,W (41-17),21,27,77.8,210,0,37,148,4.0,4,64,358,5.6,8,7,1,16,9,102,0,0,0,Pitt,/cfb/boxscores/2020-11-07-florida-state.html
9.0,2020-11-21,,Virginia Tech,W (47-14),35,52,67.3,404,2,32,152,4.8,3,84,556,6.6,22,6,2,30,9,80,0,1,1,Pitt,/cfb/boxscores/2020-11-21-pittsburgh.html
10.0,2020-11-28,@,Clemson,L (17-52),24,43,55.8,230,2,24,16,0.7,0,67,246,3.7,10,1,1,12,6,33,1,4,5,Pitt,/cfb/boxscores/2020-11-28-clemson.html
11.0,2020-12-10,@,Georgia Tech,W (34-20),17,34,50.0,196,1,54,317,5.9,2,88,513,5.8,8,14,6,28,6,60,0,1,1,Pitt,/cfb/boxscores/2020-12-10-georgia-tech.html
1.0,2020-10-24,,Iowa,W (24-20),31,50,62.0,282,3,27,104,3.9,0,77,386,5.0,14,7,3,24,3,21,0,2,2,Purdue,/cfb/boxscores/2020-10-24-purdue.html
2.0,2020-10-31,@,Illinois,W (31-24),29,35,82.9,371,2,28,89,3.2,1,63,460,7.3,18,6,2,26,11,103,2,0,2,Purdue,/cfb/boxscores/2020-10-31-illinois.html
3.0,2020-11-14,,Northwestern,L (20-27),28,51,54.9,263,2,17,2,0.1,0,68,265,3.9,11,2,2,15,6,24,1,0,1,Purdue,/cfb/boxscores/2020-11-14-purdue.html
4.0,2020-11-20,@,Minnesota,L (31-34),35,43,81.4,367,3,25,125,5.0,1,68,492,7.2,16,9,3,28,4,38,0,1,1,Purdue,/cfb/boxscores/2020-11-20-minnesota.html
5.0,2020-11-28,,Rutgers,L (30-37),20,35,57.1,237,2,33,175,5.3,2,68,412,6.1,13,11,1,25,7,47,0,1,1,Purdue,/cfb/boxscores/2020-11-28-purdue.html
6.0,2020-12-05,,Nebraska,L (27-37),33,47,70.2,334,3,17,-2,-0.1,0,64,332,5.2,15,1,3,19,11,126,0,0,0,Purdue,/cfb/boxscores/2020-12-05-purdue.html
1.0,2020-10-24,,Middle Tennessee State,L (34-40),18,35,51.4,242,4,45,183,4.1,0,80,425,5.3,12,12,2,26,5,30,2,1,3,Rice,/cfb/boxscores/2020-10-24-rice.html
2.0,2020-10-31,@,Southern Mississippi,W (30-6),12,17,70.6,233,4,50,179,3.6,0,67,412,6.1,11,11,0,22,1,5,1,0,1,Rice,/cfb/boxscores/2020-10-31-southern-mississippi.html
3.0,2020-11-21,@,North Texas,L (17-27),23,34,67.6,327,2,36,49,1.4,0,70,376,5.4,15,7,1,23,2,25,2,0,2,Rice,/cfb/boxscores/2020-11-21-north-texas.html
4.0,2020-12-05,@,Marshall,W (20-0),10,14,71.4,86,0,46,127,2.8,1,60,213,3.6,3,10,4,17,5,35,1,0,1,Rice,/cfb/boxscores/2020-12-05-marshall.html
5.0,2020-12-12,,Alabama-Birmingham,L (16-21),19,33,57.6,166,1,39,66,1.7,0,72,232,3.2,11,5,4,20,4,24,0,1,1,Rice,/cfb/boxscores/2020-12-12-rice.html
1.0,2020-10-24,@,Michigan State,W (38-27),19,30,63.3,170,1,40,111,2.8,4,70,281,4.0,9,6,1,16,9,66,2,1,3,Rutgers,/cfb/boxscores/2020-10-24-michigan-state.html
2.0,2020-10-31,,Indiana,L (21-37),22,35,62.9,126,2,33,121,3.7,1,68,247,3.6,8,8,3,19,9,66,0,3,3,Rutgers,/cfb/boxscores/2020-10-31-rutgers.html
3.0,2020-11-07,@,Ohio State,L (27-49),34,49,69.4,232,1,32,141,4.4,2,81,373,4.6,14,5,3,22,9,80,2,0,2,Rutgers,/cfb/boxscores/2020-11-07-ohio-state.html
4.0,2020-11-14,,Illinois,L (20-23),21,34,61.8,256,2,33,166,5.0,0,67,422,6.3,9,9,1,19,7,56,0,3,3,Rutgers,/cfb/boxscores/2020-11-14-rutgers.html
5.0,2020-11-21,,Michigan,L (42-48),29,44,65.9,381,3,40,105,2.6,2,84,486,5.8,17,6,1,24,12,99,0,1,1,Rutgers,/cfb/boxscores/2020-11-21-rutgers.html
6.0,2020-11-28,@,Purdue,W (37-30),22,31,71.0,236,3,49,190,3.9,1,80,426,5.3,10,13,3,26,7,56,0,0,0,Rutgers,/cfb/boxscores/2020-11-28-purdue.html
7.0,2020-12-05,,Penn State,L (7-23),18,32,56.3,122,1,32,83,2.6,0,64,205,3.2,5,6,1,12,3,30,1,0,1,Rutgers,/cfb/boxscores/2020-12-05-rutgers.html
8.0,2020-12-12,@,Maryland,W (27-24),22,39,56.4,144,1,49,235,4.8,2,88,379,4.3,7,12,5,24,6,60,0,0,0,Rutgers,/cfb/boxscores/2020-12-12-maryland.html
9.0,2020-12-18,,Nebraska,L (21-28),11,22,50.0,122,0,30,130,4.3,1,52,252,4.8,4,5,0,9,5,32,0,1,1,Rutgers,/cfb/boxscores/2020-12-18-rutgers.html
1.0,2020-10-24,,Nevada-Las Vegas,W (34-6),12,25,48.0,137,1,44,290,6.6,3,69,427,6.2,6,13,2,21,6,40,1,0,1,San Diego State,/cfb/boxscores/2020-10-24-san-diego-state.html
2.0,2020-10-31,@,Utah State,W (38-7),18,27,66.7,163,2,53,407,7.7,3,80,570,7.1,11,18,1,30,6,50,0,0,0,San Diego State,/cfb/boxscores/2020-10-31-utah-state.html
3.0,2020-11-06,,San Jose State,L (17-28),21,30,70.0,261,0,45,101,2.2,2,75,362,4.8,12,8,0,20,4,40,2,1,3,San Diego State,/cfb/boxscores/2020-11-06-san-diego-state.html
4.0,2020-11-14,,Hawaii,W (34-10),4,13,30.8,30,0,50,327,6.5,3,63,357,5.7,2,13,0,15,4,48,1,2,3,San Diego State,/cfb/boxscores/2020-11-14-san-diego-state.html
5.0,2020-11-21,@,Nevada,L (21-26),14,25,56.0,184,1,35,110,3.1,2,60,294,4.9,7,8,1,16,6,48,1,0,1,San Diego State,/cfb/boxscores/2020-11-21-nevada.html
6.0,2020-11-28,@,Colorado,L (10-20),11,28,39.3,76,0,31,79,2.5,0,59,155,2.6,3,5,2,10,7,64,0,1,1,San Diego State,/cfb/boxscores/2020-11-28-colorado.html
7.0,2020-12-05,,Colorado State,W (29-17),14,24,58.3,130,1,48,117,2.4,0,72,247,3.4,9,7,1,17,3,24,0,0,0,San Diego State,/cfb/boxscores/2020-12-05-san-diego-state.html
8.0,2020-12-12,@,Brigham Young,L (14-28),21,31,67.7,230,1,46,182,4.0,1,77,412,5.4,12,11,0,23,2,25,1,1,2,San Diego State,/cfb/boxscores/2020-12-12-brigham-young.html
1.0,2020-10-24,,Air Force,W (17-6),22,29,75.9,226,2,27,75,2.8,0,56,301,5.4,13,2,4,19,6,45,0,1,1,San Jose State,/cfb/boxscores/2020-10-24-san-jose-state.html
2.0,2020-10-31,,New Mexico,W (38-21),35,49,71.4,481,5,27,99,3.7,0,76,580,7.6,17,4,2,23,9,65,0,0,0,San Jose State,/cfb/boxscores/2020-10-31-san-jose-state.html
3.0,2020-11-06,@,San Diego State,W (28-17),18,28,64.3,182,2,29,116,4.0,2,57,298,5.2,9,6,1,16,2,15,0,1,1,San Jose State,/cfb/boxscores/2020-11-06-san-diego-state.html
4.0,2020-11-14,,Nevada-Las Vegas,W (34-17),18,29,62.1,281,2,29,176,6.1,2,58,457,7.9,11,8,4,23,5,50,0,1,1,San Jose State,/cfb/boxscores/2020-11-14-san-jose-state.html
5.0,2020-12-05,@,Hawaii,W (35-24),12,25,48.0,180,2,43,293,6.8,3,68,473,7.0,7,14,0,21,5,58,0,1,1,San Jose State,/cfb/boxscores/2020-12-05-hawaii.html
6.0,2020-12-11,N,Nevada,W (30-20),20,30,66.7,306,2,27,200,7.4,1,57,506,8.9,12,5,1,18,11,93,0,1,1,San Jose State,/cfb/boxscores/2020-12-11-san-jose-state.html
7.0,2020-12-19,N,Boise State,W (34-20),32,52,61.5,453,3,25,45,1.8,0,77,498,6.5,18,3,5,26,7,49,0,0,0,San Jose State,/cfb/boxscores/2020-12-19-san-jose-state.html
8.0,2020-12-31,N,Ball State*,L (13-34),26,46,56.5,278,1,22,69,3.1,0,68,347,5.1,11,4,3,18,8,80,0,4,4,San Jose State,/cfb/boxscores/2020-12-31-san-jose-state.html
1.0,2020-09-05,@,Texas State,W (31-24),26,36,72.2,367,1,44,177,4.0,3,80,544,6.8,12,11,3,26,7,63,1,2,3,SMU,/cfb/boxscores/2020-09-05-texas-state.html
2.0,2020-09-19,@,North Texas,W (65-35),24,33,72.7,344,4,51,366,7.2,4,84,710,8.5,14,15,4,33,4,37,0,0,0,SMU,/cfb/boxscores/2020-09-19-north-texas.html
3.0,2020-09-26,,Stephen F. Austin,W (50-7),16,27,59.3,172,2,38,260,6.8,5,65,432,6.6,10,13,1,24,7,55,0,0,0,SMU,/cfb/boxscores/2020-09-26-southern-methodist.html
4.0,2020-10-03,,Memphis,W (30-27),32,46,69.6,474,3,26,75,2.9,0,72,549,7.6,15,5,1,21,7,60,2,0,2,SMU,/cfb/boxscores/2020-10-03-southern-methodist.html
5.0,2020-10-16,@,Tulane,W (37-34),24,38,63.2,439,2,43,142,3.3,2,81,581,7.2,12,10,3,25,10,92,1,0,1,SMU,/cfb/boxscores/2020-10-16-tulane.html
6.0,2020-10-24,,Cincinnati,L (13-42),24,46,52.2,215,1,39,75,1.9,0,85,290,3.4,11,5,6,22,6,60,0,1,1,SMU,/cfb/boxscores/2020-10-24-southern-methodist.html
7.0,2020-10-31,,Navy,W (51-37),23,28,82.1,300,3,37,255,6.9,4,65,555,8.5,14,10,1,25,6,56,1,0,1,SMU,/cfb/boxscores/2020-10-31-southern-methodist.html
8.0,2020-11-07,@,Temple,W (47-23),24,35,68.6,355,4,32,194,6.1,2,67,549,8.2,16,8,0,24,2,20,0,0,0,SMU,/cfb/boxscores/2020-11-07-temple.html
9.0,2020-11-14,@,Tulsa,L (24-28),18,36,50.0,200,1,40,151,3.8,1,76,351,4.6,7,12,6,25,11,70,0,1,1,SMU,/cfb/boxscores/2020-11-14-tulsa.html
10.0,2020-11-28,@,East Carolina,L (38-52),35,51,68.6,314,2,27,70,2.6,3,78,384,4.9,16,6,4,26,8,77,1,2,3,SMU,/cfb/boxscores/2020-11-28-east-carolina.html
1.0,2020-09-03,@,Southern Mississippi,W (32-21),18,30,60.0,363,3,38,163,4.3,1,68,526,7.7,12,10,1,23,4,38,0,2,2,South Alabama,/cfb/boxscores/2020-09-03-southern-mississippi.html
2.0,2020-09-12,,Tulane,L (24-27),22,37,59.5,321,2,34,72,2.1,1,71,393,5.5,12,6,3,21,8,65,1,0,1,South Alabama,/cfb/boxscores/2020-09-12-south-alabama.html
3.0,2020-09-24,,Alabama-Birmingham,L (10-42),14,29,48.3,168,1,34,147,4.3,0,63,315,5.0,8,7,3,18,2,30,1,1,2,South Alabama,/cfb/boxscores/2020-09-24-south-alabama.html
4.0,2020-10-17,,Texas State,W (30-20),25,34,73.5,253,2,47,132,2.8,1,81,385,4.8,12,8,4,24,6,34,0,0,0,South Alabama,/cfb/boxscores/2020-10-17-south-alabama.html
5.0,2020-10-24,,Louisiana-Monroe,W (38-14),11,17,64.7,246,3,44,169,3.8,1,61,415,6.8,7,11,2,20,4,37,0,1,1,South Alabama,/cfb/boxscores/2020-10-24-south-alabama.html
6.0,2020-10-29,@,Georgia Southern,L (17-24),20,27,74.1,200,2,33,64,1.9,0,60,264,4.4,6,6,4,16,3,40,1,0,1,South Alabama,/cfb/boxscores/2020-10-29-georgia-southern.html
7.0,2020-11-07,@,Coastal Carolina,L (6-23),23,31,74.2,243,0,38,93,2.4,0,69,336,4.9,8,7,1,16,5,45,2,0,2,South Alabama,/cfb/boxscores/2020-11-07-coastal-carolina.html
8.0,2020-11-14,@,Louisiana,L (10-38),18,36,50.0,145,1,37,123,3.3,0,73,268,3.7,8,7,4,19,5,40,1,1,2,South Alabama,/cfb/boxscores/2020-11-14-louisiana-lafayette.html
9.0,2020-11-21,,Georgia State,L (14-31),25,43,58.1,211,0,37,113,3.1,2,80,324,4.1,11,7,1,19,3,30,1,0,1,South Alabama,/cfb/boxscores/2020-11-21-south-alabama.html
10.0,2020-11-28,@,Arkansas State,W (38-31),22,30,73.3,387,4,46,99,2.2,1,76,486,6.4,16,8,1,25,1,15,1,0,1,South Alabama,/cfb/boxscores/2020-11-28-arkansas-state.html
11.0,2020-12-05,,Troy,L (0-29),21,37,56.8,182,0,30,57,1.9,0,67,239,3.6,10,7,0,17,1,10,1,1,2,South Alabama,/cfb/boxscores/2020-12-05-south-alabama.html
1.0,2020-09-26,,Tennessee,L (27-31),25,39,64.1,290,1,35,89,2.5,2,74,379,5.1,15,5,2,22,4,40,1,1,2,South Carolina,/cfb/boxscores/2020-09-26-south-carolina.html
2.0,2020-10-03,@,Florida,L (24-38),28,47,59.6,212,2,36,117,3.3,1,83,329,4.0,12,12,1,25,6,55,1,0,1,South Carolina,/cfb/boxscores/2020-10-03-florida.html
3.0,2020-10-10,@,Vanderbilt,W (41-7),16,24,66.7,196,0,39,289,7.4,5,63,485,7.7,9,8,1,18,4,20,1,0,1,South Carolina,/cfb/boxscores/2020-10-10-vanderbilt.html
4.0,2020-10-17,,Auburn,W (30-22),15,24,62.5,144,1,43,153,3.6,3,67,297,4.4,8,8,4,20,5,39,0,1,1,South Carolina,/cfb/boxscores/2020-10-17-south-carolina.html
5.0,2020-10-24,@,Louisiana State,L (24-52),12,22,54.5,234,1,29,169,5.8,2,51,403,7.9,9,6,2,17,7,55,0,1,1,South Carolina,/cfb/boxscores/2020-10-24-louisiana-state.html
6.0,2020-11-07,,Texas A&M,L (3-48),12,28,42.9,100,0,25,50,2.0,0,53,150,2.8,7,1,1,9,1,5,0,2,2,South Carolina,/cfb/boxscores/2020-11-07-south-carolina.html
7.0,2020-11-14,@,Mississippi,L (42-59),17,29,58.6,230,1,39,318,8.2,5,68,548,8.1,12,15,0,27,4,53,0,1,1,South Carolina,/cfb/boxscores/2020-11-14-mississippi.html
8.0,2020-11-21,,Missouri,L (10-17),20,33,60.6,169,0,36,114,3.2,1,69,283,4.1,8,6,4,18,11,85,0,1,1,South Carolina,/cfb/boxscores/2020-11-21-south-carolina.html
9.0,2020-11-28,,Georgia,L (16-45),18,22,81.8,190,1,43,83,1.9,1,65,273,4.2,8,9,1,18,2,10,0,1,1,South Carolina,/cfb/boxscores/2020-11-28-south-carolina.html
10.0,2020-12-05,@,Kentucky,L (18-41),12,27,44.4,107,1,44,297,6.8,1,71,404,5.7,6,14,1,21,6,75,3,1,4,South Carolina,/cfb/boxscores/2020-12-05-kentucky.html
1.0,2020-09-12,,The Citadel,W (27-6),18,25,72.0,102,1,39,302,7.7,2,64,404,6.3,7,13,0,20,5,50,0,0,0,South Florida,/cfb/boxscores/2020-09-12-south-florida.html
2.0,2020-09-19,@,Notre Dame,L (0-52),12,29,41.4,125,0,33,106,3.2,0,62,231,3.7,5,5,1,11,4,40,0,0,0,South Florida,/cfb/boxscores/2020-09-19-notre-dame.html
3.0,2020-10-03,@,Cincinnati,L (7-28),21,41,51.2,208,0,33,83,2.5,1,74,291,3.9,12,5,2,19,3,40,0,5,5,South Florida,/cfb/boxscores/2020-10-03-cincinnati.html
4.0,2020-10-10,,East Carolina,L (24-44),28,38,73.7,306,0,34,92,2.7,3,72,398,5.5,12,8,2,22,5,66,2,0,2,South Florida,/cfb/boxscores/2020-10-10-south-florida.html
5.0,2020-10-17,@,Temple,L (37-39),16,29,55.2,181,3,44,143,3.3,2,73,324,4.4,6,12,3,21,11,107,3,0,3,South Florida,/cfb/boxscores/2020-10-17-temple.html
6.0,2020-10-23,,Tulsa,L (13-42),22,36,61.1,183,1,34,122,3.6,0,70,305,4.4,10,5,2,17,6,30,2,1,3,South Florida,/cfb/boxscores/2020-10-23-south-florida.html
7.0,2020-11-07,@,Memphis,L (33-34),20,29,69.0,217,2,33,113,3.4,0,62,330,5.3,9,7,0,16,4,38,0,0,0,South Florida,/cfb/boxscores/2020-11-07-memphis.html
8.0,2020-11-14,@,Houston,L (21-56),18,39,46.2,223,1,41,136,3.3,1,80,359,4.5,14,7,3,24,2,21,2,0,2,South Florida,/cfb/boxscores/2020-11-14-houston.html
9.0,2020-11-27,,Central Florida,L (46-58),32,47,68.1,404,4,46,242,5.3,2,93,646,6.9,22,14,2,38,8,60,2,0,2,South Florida,/cfb/boxscores/2020-11-27-south-florida.html
1.0,2020-09-03,,South Alabama,L (21-32),22,32,68.8,314,0,37,95,2.6,2,69,409,5.9,12,6,2,20,7,49,0,0,0,Southern Mississippi,/cfb/boxscores/2020-09-03-southern-mississippi.html
2.0,2020-09-19,,Louisiana Tech,L (30-31),24,32,75.0,264,3,30,129,4.3,1,62,393,6.3,11,9,1,21,5,45,0,1,1,Southern Mississippi,/cfb/boxscores/2020-09-19-southern-mississippi.html
3.0,2020-09-26,,Tulane,L (24-66),23,38,60.5,299,2,34,70,2.1,1,72,369,5.1,11,6,2,19,2,13,1,1,2,Southern Mississippi,/cfb/boxscores/2020-09-26-southern-mississippi.html
4.0,2020-10-03,@,North Texas,W (41-31),16,30,53.3,235,2,46,202,4.4,3,76,437,5.8,10,11,1,22,2,10,0,1,1,Southern Mississippi,/cfb/boxscores/2020-10-03-north-texas.html
5.0,2020-10-24,@,Liberty,L (35-56),16,27,59.3,201,1,41,215,5.2,4,68,416,6.1,9,9,1,19,5,42,0,1,1,Southern Mississippi,/cfb/boxscores/2020-10-24-liberty.html
6.0,2020-10-31,,Rice,L (6-30),17,23,73.9,169,0,28,100,3.6,0,51,269,5.3,6,5,0,11,4,25,2,1,3,Southern Mississippi,/cfb/boxscores/2020-10-31-southern-mississippi.html
7.0,2020-11-07,,North Alabama,W (24-13),12,20,60.0,100,0,42,245,5.8,3,62,345,5.6,8,14,1,23,5,41,2,2,4,Southern Mississippi,/cfb/boxscores/2020-11-07-southern-mississippi.html
8.0,2020-11-14,@,Western Kentucky,L (7-10),6,14,42.9,67,0,37,154,4.2,1,51,221,4.3,5,7,1,13,1,15,0,0,0,Southern Mississippi,/cfb/boxscores/2020-11-14-western-kentucky.html
9.0,2020-11-21,,UTSA,L (20-23),22,39,56.4,272,2,26,75,2.9,0,65,347,5.3,11,4,3,18,5,44,0,1,1,Southern Mississippi,/cfb/boxscores/2020-11-21-southern-mississippi.html
10.0,2020-12-10,,Florida Atlantic,W (45-31),13,19,68.4,209,2,48,305,6.4,3,67,514,7.7,10,12,0,22,8,83,2,1,3,Southern Mississippi,/cfb/boxscores/2020-12-10-southern-mississippi.html
1.0,2020-11-07,@,Oregon,L (14-35),16,26,61.5,216,0,31,197,6.4,2,57,413,7.2,8,5,3,16,10,100,0,0,0,Stanford,/cfb/boxscores/2020-11-07-oregon.html
2.0,2020-11-14,,Colorado,L (32-35),31,56,55.4,327,1,21,70,3.3,2,77,397,5.2,16,3,5,24,7,50,1,0,1,Stanford,/cfb/boxscores/2020-11-14-stanford.html
3.0,2020-11-27,@,California,W (24-23),24,32,75.0,209,1,34,93,2.7,2,66,302,4.6,9,6,1,16,6,75,0,0,0,Stanford,/cfb/boxscores/2020-11-27-california.html
4.0,2020-12-05,@,Washington,W (31-26),20,31,64.5,252,1,40,191,4.8,3,71,443,6.2,14,9,0,23,3,25,1,0,1,Stanford,/cfb/boxscores/2020-12-05-washington.html
5.0,2020-12-12,@,Oregon State,W (27-24),22,30,73.3,292,1,35,116,3.3,2,65,408,6.3,14,7,1,22,4,35,0,0,0,Stanford,/cfb/boxscores/2020-12-12-oregon-state.html
6.0,2020-12-19,@,UCLA,W (48-47),32,47,68.1,428,3,36,132,3.7,4,83,560,6.7,21,8,1,30,4,25,0,3,3,Stanford,/cfb/boxscores/2020-12-19-ucla.html
1.0,2020-09-12,@,North Carolina,L (6-31),16,38,42.1,134,0,35,68,1.9,0,73,202,2.8,9,4,2,15,8,60,0,1,1,Syracuse,/cfb/boxscores/2020-09-12-north-carolina.html
2.0,2020-09-19,@,Pittsburgh,L (10-21),13,24,54.2,120,1,34,51,1.5,0,58,171,2.9,3,6,1,10,5,53,1,1,2,Syracuse,/cfb/boxscores/2020-09-19-pittsburgh.html
3.0,2020-09-26,,Georgia Tech,W (37-20),13,24,54.2,194,2,41,163,4.0,2,65,357,5.5,7,6,1,14,7,85,0,1,1,Syracuse,/cfb/boxscores/2020-09-26-syracuse.html
4.0,2020-10-10,,Duke,L (24-38),14,29,48.3,258,2,23,28,1.2,0,52,286,5.5,9,1,1,11,5,45,0,0,0,Syracuse,/cfb/boxscores/2020-10-10-syracuse.html
5.0,2020-10-17,,Liberty,L (21-38),19,40,47.5,211,3,27,97,3.6,0,67,308,4.6,10,8,1,19,10,80,0,1,1,Syracuse,/cfb/boxscores/2020-10-17-syracuse.html
6.0,2020-10-24,@,Clemson,L (21-47),10,26,38.5,175,1,32,150,4.7,1,58,325,5.6,7,4,0,11,5,35,1,3,4,Syracuse,/cfb/boxscores/2020-10-24-clemson.html
7.0,2020-10-31,,Wake Forest,L (14-38),22,34,64.7,142,2,22,79,3.6,0,56,221,3.9,6,6,1,13,8,81,1,2,3,Syracuse,/cfb/boxscores/2020-10-31-syracuse.html
8.0,2020-11-07,,Boston College,L (13-16),19,30,63.3,188,1,21,52,2.5,0,51,240,4.7,8,4,2,14,7,69,1,1,2,Syracuse,/cfb/boxscores/2020-11-07-syracuse.html
9.0,2020-11-20,@,Louisville,L (0-30),6,16,37.5,45,0,25,92,3.7,0,41,137,3.3,2,5,0,7,8,68,2,1,3,Syracuse,/cfb/boxscores/2020-11-20-louisville.html
10.0,2020-11-28,,North Carolina State,L (29-36),23,45,51.1,254,2,25,3,0.1,0,70,257,3.7,12,2,2,16,7,74,0,0,0,Syracuse,/cfb/boxscores/2020-11-28-syracuse.html
11.0,2020-12-05,@,Notre Dame,L (21-45),18,30,60.0,185,1,35,229,6.5,2,65,414,6.4,7,7,1,15,8,90,3,1,4,Syracuse,/cfb/boxscores/2020-12-05-notre-dame.html
1.0,2020-10-10,@,Navy,L (29-31),22,31,71.0,241,1,33,166,5.0,3,64,407,6.4,14,8,3,25,4,30,0,1,1,Temple,/cfb/boxscores/2020-10-10-navy.html
2.0,2020-10-17,,South Florida,W (39-37),30,42,71.4,270,4,43,146,3.4,0,85,416,4.9,21,8,3,32,5,54,0,2,2,Temple,/cfb/boxscores/2020-10-17-temple.html
3.0,2020-10-24,@,Memphis,L (29-41),41,63,65.1,392,4,33,128,3.9,0,96,520,5.4,19,7,4,30,6,75,1,3,4,Temple,/cfb/boxscores/2020-10-24-memphis.html
4.0,2020-10-31,@,Tulane,L (3-38),16,26,61.5,150,0,36,82,2.3,0,62,232,3.7,6,5,0,11,5,38,0,1,1,Temple,/cfb/boxscores/2020-10-31-tulane.html
5.0,2020-11-07,,Southern Methodist,L (23-47),17,30,56.7,211,2,43,157,3.7,1,73,368,5.0,10,9,0,19,4,30,0,0,0,Temple,/cfb/boxscores/2020-11-07-temple.html
6.0,2020-11-14,@,Central Florida,L (13-38),10,25,40.0,107,0,50,183,3.7,1,75,290,3.9,5,12,2,19,4,35,1,2,3,Temple,/cfb/boxscores/2020-11-14-central-florida.html
7.0,2020-11-21,,East Carolina,L (3-28),10,23,43.5,95,0,46,140,3.0,0,69,235,3.4,5,5,0,10,10,59,1,2,3,Temple,/cfb/boxscores/2020-11-21-temple.html
1.0,2020-09-26,@,South Carolina,W (31-27),20,32,62.5,261,1,33,133,4.0,2,65,394,6.1,13,6,2,21,6,50,0,0,0,Tennessee,/cfb/boxscores/2020-09-26-south-carolina.html
2.0,2020-10-03,,Missouri,W (35-12),14,23,60.9,190,1,51,232,4.5,4,74,422,5.7,9,15,2,26,3,20,0,0,0,Tennessee,/cfb/boxscores/2020-10-03-tennessee.html
3.0,2020-10-10,@,Georgia,L (21-44),23,36,63.9,215,2,27,-1,0.0,0,63,214,3.4,9,2,2,13,10,84,2,1,3,Tennessee,/cfb/boxscores/2020-10-10-georgia.html
4.0,2020-10-17,,Kentucky,L (7-34),15,26,57.7,112,0,41,175,4.3,1,67,287,4.3,7,11,0,18,6,63,1,3,4,Tennessee,/cfb/boxscores/2020-10-17-tennessee.html
5.0,2020-10-24,,Alabama,L (17-48),14,25,56.0,163,2,38,139,3.7,0,63,302,4.8,7,7,2,16,8,33,1,0,1,Tennessee,/cfb/boxscores/2020-10-24-tennessee.html
6.0,2020-11-07,@,Arkansas,L (13-24),11,21,52.4,107,0,50,185,3.7,1,71,292,4.1,6,11,2,19,3,30,0,2,2,Tennessee,/cfb/boxscores/2020-11-07-arkansas.html
7.0,2020-11-21,@,Auburn,L (17-30),22,33,66.7,242,0,41,222,5.4,2,74,464,6.3,12,13,3,28,4,33,0,1,1,Tennessee,/cfb/boxscores/2020-11-21-auburn.html
8.0,2020-12-05,,Florida,L (19-31),27,37,73.0,240,2,39,94,2.4,1,76,334,4.4,13,8,3,24,5,40,0,0,0,Tennessee,/cfb/boxscores/2020-12-05-tennessee.html
9.0,2020-12-12,@,Vanderbilt,W (42-17),21,32,65.6,328,4,38,212,5.6,1,70,540,7.7,10,13,1,24,10,94,1,1,2,Tennessee,/cfb/boxscores/2020-12-12-vanderbilt.html
10.0,2020-12-19,,Texas A&M,L (13-34),12,20,60.0,189,2,17,24,1.4,0,37,213,5.8,8,3,2,13,6,55,1,1,2,Tennessee,/cfb/boxscores/2020-12-19-tennessee.html
1.0,2020-09-12,,UTEP,W (59-3),29,41,70.7,481,7,33,208,6.3,1,74,689,9.3,21,7,0,28,6,55,0,0,0,Texas,/cfb/boxscores/2020-09-12-texas.html
2.0,2020-09-26,@,Texas Tech,W (63-56),27,41,65.9,262,5,48,214,4.5,2,89,476,5.3,13,13,1,27,10,100,1,1,2,Texas,/cfb/boxscores/2020-09-26-texas-tech.html
3.0,2020-10-03,,TCU,L (31-33),17,36,47.2,236,4,24,152,6.3,0,60,388,6.5,8,6,2,16,12,92,1,1,2,Texas,/cfb/boxscores/2020-10-03-texas.html
4.0,2020-10-10,N,Oklahoma,L (45-53),30,53,56.6,287,2,34,141,4.1,4,87,428,4.9,12,9,6,27,11,101,1,2,3,Texas,/cfb/boxscores/2020-10-10-oklahoma.html
5.0,2020-10-24,,Baylor,W (27-16),15,23,65.2,270,1,47,159,3.4,2,70,429,6.1,9,9,1,19,5,50,0,1,1,Texas,/cfb/boxscores/2020-10-24-texas.html
6.0,2020-10-31,@,Oklahoma State,W (41-34),18,35,51.4,169,3,40,118,3.0,1,75,287,3.8,7,5,5,17,13,142,0,0,0,Texas,/cfb/boxscores/2020-10-31-oklahoma-state.html
7.0,2020-11-07,,West Virginia,W (17-13),15,31,48.4,184,2,36,179,5.0,0,67,363,5.4,8,7,2,17,4,45,0,0,0,Texas,/cfb/boxscores/2020-11-07-texas.html
8.0,2020-11-27,,Iowa State,L (20-23),18,30,60.0,303,1,35,145,4.1,1,65,448,6.9,11,9,1,21,7,56,1,0,1,Texas,/cfb/boxscores/2020-11-27-texas.html
9.0,2020-12-05,@,Kansas State,W (69-31),20,27,74.1,274,2,33,334,10.1,7,60,608,10.1,13,13,0,26,4,55,0,0,0,Texas,/cfb/boxscores/2020-12-05-kansas-state.html
10.0,2020-12-29,N,Colorado*,W (55-23),19,28,67.9,335,5,40,303,7.6,2,68,638,9.4,11,12,3,26,10,89,0,0,0,Texas,/cfb/boxscores/2020-12-29-colorado.html
1.0,2020-09-26,,Vanderbilt,W (17-12),17,28,60.7,189,1,27,183,6.8,1,55,372,6.8,8,7,2,17,8,50,3,0,3,Texas A&M,/cfb/boxscores/2020-09-26-texas-am.html
2.0,2020-10-03,@,Alabama,L (24-52),26,47,55.3,335,3,30,115,3.8,0,77,450,5.8,16,8,1,25,7,58,0,2,2,Texas A&M,/cfb/boxscores/2020-10-03-alabama.html
3.0,2020-10-10,,Florida,W (41-38),25,36,69.4,338,3,38,205,5.4,2,74,543,7.3,17,13,2,32,5,67,1,0,1,Texas A&M,/cfb/boxscores/2020-10-10-texas-am.html
4.0,2020-10-17,@,Mississippi State,W (28-14),13,23,56.5,139,2,34,186,5.5,2,57,325,5.7,4,13,0,17,5,40,0,1,1,Texas A&M,/cfb/boxscores/2020-10-17-mississippi-state.html
5.0,2020-10-31,,Arkansas,W (42-31),21,26,80.8,260,3,36,182,5.1,3,62,442,7.1,12,9,4,25,9,100,0,0,0,Texas A&M,/cfb/boxscores/2020-10-31-texas-am.html
6.0,2020-11-07,@,South Carolina,W (48-3),17,27,63.0,266,5,45,264,5.9,2,72,530,7.4,10,16,0,26,2,25,0,0,0,Texas A&M,/cfb/boxscores/2020-11-07-south-carolina.html
7.0,2020-11-28,,Louisiana State,W (20-7),11,34,32.4,105,0,36,163,4.5,1,70,268,3.8,5,8,3,16,9,83,0,0,0,Texas A&M,/cfb/boxscores/2020-11-28-texas-am.html
8.0,2020-12-05,@,Auburn,W (31-20),18,23,78.3,196,2,47,313,6.7,2,70,509,7.3,11,18,0,29,4,39,0,0,0,Texas A&M,/cfb/boxscores/2020-12-05-auburn.html
9.0,2020-12-19,@,Tennessee,W (34-13),26,32,81.3,281,1,47,216,4.6,3,79,497,6.3,16,11,1,28,4,30,0,1,1,Texas A&M,/cfb/boxscores/2020-12-19-tennessee.html
10.0,2021-01-02,N,North Carolina*,W (41-27),16,26,61.5,232,0,35,225,6.4,5,61,457,7.5,7,10,3,19,9,87,0,0,0,Texas A&M,/cfb/boxscores/2021-01-02-north-carolina.html
1.0,2020-09-26,,Iowa State,L (34-37),27,40,67.5,399,4,43,113,2.6,0,83,512,6.2,16,10,1,27,10,66,1,1,2,Texas Christian,/cfb/boxscores/2020-09-26-texas-christian.html
2.0,2020-10-03,@,Texas,W (33-31),20,30,66.7,231,0,51,227,4.5,3,81,458,5.7,10,13,2,25,14,109,1,0,1,Texas Christian,/cfb/boxscores/2020-10-03-texas.html
3.0,2020-10-10,,Kansas State,L (14-21),22,38,57.9,153,0,37,189,5.1,2,75,342,4.6,9,8,3,20,5,38,0,1,1,Texas Christian,/cfb/boxscores/2020-10-10-texas-christian.html
4.0,2020-10-24,,Oklahoma,L (14-33),25,35,71.4,276,1,25,75,3.0,1,60,351,5.9,9,5,4,18,10,94,0,0,0,Texas Christian,/cfb/boxscores/2020-10-24-texas-christian.html
5.0,2020-10-31,@,Baylor,W (33-23),14,23,60.9,138,1,44,247,5.6,2,67,385,5.7,7,11,2,20,7,64,1,0,1,Texas Christian,/cfb/boxscores/2020-10-31-baylor.html
6.0,2020-11-07,,Texas Tech,W (34-18),11,23,47.8,73,0,49,270,5.5,4,72,343,4.8,3,8,3,14,7,75,0,1,1,Texas Christian,/cfb/boxscores/2020-11-07-texas-christian.html
7.0,2020-11-14,@,West Virginia,L (6-24),16,29,55.2,161,0,34,134,3.9,0,63,295,4.7,6,11,2,19,3,25,1,1,2,Texas Christian,/cfb/boxscores/2020-11-14-west-virginia.html
8.0,2020-11-28,@,Kansas,W (59-23),6,15,40.0,106,3,41,337,8.2,2,56,443,7.9,3,13,0,16,10,77,0,0,0,Texas Christian,/cfb/boxscores/2020-11-28-kansas.html
9.0,2020-12-05,,Oklahoma State,W (29-22),12,26,46.2,265,1,52,236,4.5,3,78,501,6.4,7,14,1,22,4,40,4,1,5,Texas Christian,/cfb/boxscores/2020-12-05-texas-christian.html
10.0,2020-12-12,,Louisiana Tech,W (52-10),11,14,78.6,161,1,35,333,9.5,6,49,494,10.1,5,9,1,15,7,45,1,0,1,Texas Christian,/cfb/boxscores/2020-12-12-texas-christian.html
1.0,2020-09-05,,Southern Methodist,L (24-31),21,39,53.8,227,2,38,189,5.0,1,77,416,5.4,11,9,2,22,4,43,1,1,2,Texas State,/cfb/boxscores/2020-09-05-texas-state.html
2.0,2020-09-12,,UTSA,L (48-51),27,41,65.9,349,4,37,123,3.3,2,78,472,6.1,12,10,4,26,6,60,0,2,2,Texas State,/cfb/boxscores/2020-09-12-texas-state.html
3.0,2020-09-19,@,Louisiana-Monroe,W (38-17),14,21,66.7,256,2,38,142,3.7,2,59,398,6.7,8,11,1,20,6,70,1,0,1,Texas State,/cfb/boxscores/2020-09-19-louisiana-monroe.html
4.0,2020-09-26,@,Boston College,L (21-24),19,29,65.5,229,2,40,128,3.2,1,69,357,5.2,10,8,3,21,7,61,0,1,1,Texas State,/cfb/boxscores/2020-09-26-boston-college.html
5.0,2020-10-10,@,Troy,L (17-37),15,31,48.4,93,1,36,161,4.5,1,67,254,3.8,4,7,4,15,7,66,1,0,1,Texas State,/cfb/boxscores/2020-10-10-troy.html
6.0,2020-10-17,@,South Alabama,L (20-30),28,40,70.0,260,1,26,88,3.4,1,66,348,5.3,15,6,1,22,6,52,0,0,0,Texas State,/cfb/boxscores/2020-10-17-south-alabama.html
7.0,2020-10-24,@,Brigham Young,L (14-52),17,31,54.8,150,2,26,117,4.5,0,57,267,4.7,8,5,2,15,6,55,0,2,2,Texas State,/cfb/boxscores/2020-10-24-brigham-young.html
8.0,2020-10-31,,Louisiana,L (34-44),15,33,45.5,178,1,40,204,5.1,4,73,382,5.2,9,10,7,26,4,26,0,3,3,Texas State,/cfb/boxscores/2020-10-31-texas-state.html
9.0,2020-11-07,,Appalachian State,L (17-38),21,38,55.3,205,2,30,215,7.2,0,68,420,6.2,8,9,4,21,6,72,0,2,2,Texas State,/cfb/boxscores/2020-11-07-texas-state.html
10.0,2020-11-14,@,Georgia Southern,L (38-40),19,32,59.4,269,3,19,30,1.6,1,51,299,5.9,10,6,2,18,3,30,0,3,3,Texas State,/cfb/boxscores/2020-11-14-georgia-southern.html
11.0,2020-11-21,,Arkansas State,W (47-45),32,45,71.1,443,5,18,62,3.4,1,63,505,8.0,19,5,3,27,3,25,0,0,0,Texas State,/cfb/boxscores/2020-11-21-texas-state.html
12.0,2020-11-28,,Coastal Carolina,L (14-49),20,26,76.9,202,1,24,116,4.8,1,50,318,6.4,9,3,1,13,4,37,1,0,1,Texas State,/cfb/boxscores/2020-11-28-texas-state.html
1.0,2020-09-12,,Houston Christian,W (35-33),38,52,73.1,430,2,43,194,4.5,3,95,624,6.6,22,12,1,35,13,104,0,1,1,Texas Tech,/cfb/boxscores/2020-09-12-texas-tech.html
2.0,2020-09-26,,Texas,L (56-63),31,52,59.6,331,5,23,116,5.0,2,75,447,6.0,16,5,3,24,4,15,0,3,3,Texas Tech,/cfb/boxscores/2020-09-26-texas-tech.html
3.0,2020-10-03,@,Kansas State,L (21-31),34,49,69.4,267,2,34,204,6.0,1,83,471,5.7,13,13,1,27,6,71,0,1,1,Texas Tech,/cfb/boxscores/2020-10-03-kansas-state.html
4.0,2020-10-10,@,Iowa State,L (15-31),23,34,67.6,212,1,22,58,2.6,0,56,270,4.8,11,3,1,15,4,33,0,0,0,Texas Tech,/cfb/boxscores/2020-10-10-iowa-state.html
5.0,2020-10-24,,West Virginia,W (34-27),22,28,78.6,169,1,39,179,4.6,3,67,348,5.2,8,7,3,18,3,19,1,0,1,Texas Tech,/cfb/boxscores/2020-10-24-texas-tech.html
6.0,2020-10-31,,Oklahoma,L (28-62),19,32,59.4,266,2,29,134,4.6,2,61,400,6.6,9,8,1,18,11,85,1,2,3,Texas Tech,/cfb/boxscores/2020-10-31-texas-tech.html
7.0,2020-11-07,@,TCU,L (18-34),23,41,56.1,234,2,26,77,3.0,0,67,311,4.6,9,5,1,15,6,60,0,1,1,Texas Tech,/cfb/boxscores/2020-11-07-texas-christian.html
8.0,2020-11-14,,Baylor,W (24-23),23,38,60.5,257,0,39,124,3.2,2,77,381,4.9,11,7,1,19,6,50,1,1,2,Texas Tech,/cfb/boxscores/2020-11-14-texas-tech.html
9.0,2020-11-28,@,Oklahoma State,L (44-50),31,46,67.4,384,3,38,255,6.7,3,84,639,7.6,15,11,0,26,7,60,2,1,3,Texas Tech,/cfb/boxscores/2020-11-28-oklahoma-state.html
10.0,2020-12-05,,Kansas,W (16-13),15,26,57.7,117,0,43,293,6.8,1,69,410,5.9,4,11,2,17,7,80,3,1,4,Texas Tech,/cfb/boxscores/2020-12-05-texas-tech.html
1.0,2020-11-04,,Bowling Green State,W (38-3),20,32,62.5,214,4,52,310,6.0,1,84,524,6.2,10,14,2,26,12,71,1,0,1,Toledo,/cfb/boxscores/2020-11-04-toledo.html
2.0,2020-11-11,@,Western Michigan,L (38-41),30,46,65.2,339,1,39,162,4.2,4,85,501,5.9,17,9,3,29,11,63,0,1,1,Toledo,/cfb/boxscores/2020-11-11-western-michigan.html
3.0,2020-11-18,@,Eastern Michigan,W (45-28),16,24,66.7,298,4,44,191,4.3,1,68,489,7.2,10,13,4,27,8,87,2,0,2,Toledo,/cfb/boxscores/2020-11-18-eastern-michigan.html
4.0,2020-11-28,,Ball State,L (24-27),30,40,75.0,407,3,28,42,1.5,0,68,449,6.6,14,4,2,20,12,101,1,1,2,Toledo,/cfb/boxscores/2020-11-28-toledo.html
5.0,2020-12-05,@,Northern Illinois,W (41-24),29,44,65.9,432,3,37,178,4.8,2,81,610,7.5,21,10,3,34,11,112,0,2,2,Toledo,/cfb/boxscores/2020-12-05-northern-illinois.html
6.0,2020-12-12,,Central Michigan,W (24-23),18,33,54.5,265,3,43,126,2.9,0,76,391,5.1,12,11,2,25,4,17,1,3,4,Toledo,/cfb/boxscores/2020-12-12-toledo.html
1.0,2020-09-19,@,Middle Tennessee State,W (47-14),27,38,71.1,256,3,53,244,4.6,3,91,500,5.5,14,15,1,30,4,45,1,1,2,Troy,/cfb/boxscores/2020-09-19-middle-tennessee-state.html
2.0,2020-09-26,@,Brigham Young,L (7-48),21,36,58.3,162,0,18,19,1.1,1,54,181,3.4,7,1,0,8,5,50,0,0,0,Troy,/cfb/boxscores/2020-09-26-brigham-young.html
3.0,2020-10-10,,Texas State,W (37-17),33,46,71.7,338,4,35,150,4.3,1,81,488,6.0,17,6,3,26,6,72,0,0,0,Troy,/cfb/boxscores/2020-10-10-troy.html
4.0,2020-10-17,,Eastern Kentucky,W (31-29),26,38,68.4,333,3,34,174,5.1,1,72,507,7.0,17,9,1,27,8,88,1,2,3,Troy,/cfb/boxscores/2020-10-17-troy.html
5.0,2020-10-24,,Georgia State,L (34-36),32,48,66.7,407,3,19,40,2.1,0,67,447,6.7,17,3,3,23,7,61,2,2,4,Troy,/cfb/boxscores/2020-10-24-troy.html
6.0,2020-10-31,@,Arkansas State,W (38-10),33,45,73.3,419,2,36,68,1.9,2,81,487,6.0,21,4,2,27,6,41,0,0,0,Troy,/cfb/boxscores/2020-10-31-arkansas-state.html
7.0,2020-11-07,@,Georgia Southern,L (13-20),21,47,44.7,201,0,14,34,2.4,0,61,235,3.9,11,2,1,14,3,27,0,2,2,Troy,/cfb/boxscores/2020-11-07-georgia-southern.html
8.0,2020-11-21,,Middle Tennessee State,L (17-20),25,39,64.1,300,1,23,92,4.0,1,62,392,6.3,12,6,0,18,5,39,0,2,2,Troy,/cfb/boxscores/2020-11-21-troy.html
9.0,2020-11-28,@,Appalachian State,L (10-47),13,22,59.1,125,1,33,106,3.2,0,55,231,4.2,4,7,2,13,7,57,0,1,1,Troy,/cfb/boxscores/2020-11-28-appalachian-state.html
10.0,2020-12-05,@,South Alabama,W (29-0),34,42,81.0,297,3,35,117,3.3,0,77,414,5.4,16,8,1,25,1,10,0,1,1,Troy,/cfb/boxscores/2020-12-05-south-alabama.html
11.0,2020-12-12,,Coastal Carolina,L (38-42),34,55,61.8,354,2,26,89,3.4,2,81,443,5.5,21,6,2,29,3,19,1,2,3,Troy,/cfb/boxscores/2020-12-12-troy.html
1.0,2020-09-12,@,South Alabama,W (27-24),14,30,46.7,191,0,37,206,5.6,4,67,397,5.9,11,9,2,22,4,45,1,0,1,Tulane,/cfb/boxscores/2020-09-12-south-alabama.html
2.0,2020-09-19,,Navy,L (24-27),10,25,40.0,108,0,44,265,6.0,3,69,373,5.4,4,13,1,18,5,50,0,1,1,Tulane,/cfb/boxscores/2020-09-19-tulane.html
3.0,2020-09-26,@,Southern Mississippi,W (66-24),9,21,42.9,142,2,54,427,7.9,7,75,569,7.6,7,18,1,26,7,40,1,0,1,Tulane,/cfb/boxscores/2020-09-26-southern-mississippi.html
4.0,2020-10-08,@,Houston,L (31-49),11,25,44.0,141,1,45,70,1.6,1,70,211,3.0,7,6,3,16,8,66,0,0,0,Tulane,/cfb/boxscores/2020-10-08-houston.html
5.0,2020-10-16,,Southern Methodist,L (34-37),12,29,41.4,192,1,48,195,4.1,3,77,387,5.0,8,11,4,23,11,86,0,1,1,Tulane,/cfb/boxscores/2020-10-16-tulane.html
6.0,2020-10-24,@,Central Florida,L (34-51),14,24,58.3,215,3,38,125,3.3,2,62,340,5.5,13,8,0,21,2,10,0,1,1,Tulane,/cfb/boxscores/2020-10-24-central-florida.html
7.0,2020-10-31,,Temple,W (38-3),13,22,59.1,220,3,47,284,6.0,2,69,504,7.3,10,17,1,28,6,47,2,1,3,Tulane,/cfb/boxscores/2020-10-31-tulane.html
8.0,2020-11-07,@,East Carolina,W (38-21),22,34,64.7,216,3,34,277,8.1,2,68,493,7.3,12,11,1,24,8,65,0,1,1,Tulane,/cfb/boxscores/2020-11-07-east-carolina.html
9.0,2020-11-14,,Army,W (38-12),19,27,70.4,197,2,32,171,5.3,2,59,368,6.2,9,8,0,17,2,20,0,0,0,Tulane,/cfb/boxscores/2020-11-14-tulane.html
10.0,2020-11-19,@,Tulsa,L (24-30),8,17,47.1,76,2,51,226,4.4,1,68,302,4.4,3,13,2,18,7,63,0,1,1,Tulane,/cfb/boxscores/2020-11-19-tulsa.html
11.0,2020-12-05,,Memphis,W (35-21),21,34,61.8,254,2,45,165,3.7,3,79,419,5.3,12,13,1,26,9,84,0,1,1,Tulane,/cfb/boxscores/2020-12-05-tulane.html
12.0,2020-12-22,N,Nevada*,L (27-38),12,25,48.0,168,2,38,197,5.2,2,63,365,5.8,7,9,2,18,5,31,0,3,3,Tulane,/cfb/boxscores/2020-12-22-nevada.html
1.0,2020-09-19,@,Oklahoma State,L (7-16),18,28,64.3,165,1,32,112,3.5,0,60,277,4.6,6,5,4,15,15,120,0,1,1,Tulsa,/cfb/boxscores/2020-09-19-oklahoma-state.html
2.0,2020-10-03,@,Central Florida,W (34-26),17,29,58.6,273,3,44,165,3.8,1,73,438,6.0,11,9,1,21,8,95,2,1,3,Tulsa,/cfb/boxscores/2020-10-03-central-florida.html
3.0,2020-10-23,@,South Florida,W (42-13),17,25,68.0,235,1,37,227,6.1,4,62,462,7.5,11,10,0,21,5,40,0,1,1,Tulsa,/cfb/boxscores/2020-10-23-south-florida.html
4.0,2020-10-30,,East Carolina,W (34-30),19,37,51.4,253,2,37,175,4.7,2,74,428,5.8,11,11,3,25,10,109,1,2,3,Tulsa,/cfb/boxscores/2020-10-30-tulsa.html
5.0,2020-11-14,,Southern Methodist,W (28-24),26,38,68.4,325,3,45,130,2.9,1,83,455,5.5,18,9,0,27,13,117,1,1,2,Tulsa,/cfb/boxscores/2020-11-14-tulsa.html
6.0,2020-11-19,,Tulane,W (30-24),27,48,56.3,343,2,41,179,4.4,1,89,522,5.9,15,10,1,26,10,85,2,1,3,Tulsa,/cfb/boxscores/2020-11-19-tulsa.html
7.0,2020-12-05,@,Navy,W (19-6),10,25,40.0,168,1,43,128,3.0,0,68,296,4.4,6,9,0,15,6,60,1,0,1,Tulsa,/cfb/boxscores/2020-12-05-navy.html
8.0,2020-12-19,@,Cincinnati,L (24-27),13,30,43.3,166,1,37,199,5.4,2,67,365,5.4,7,13,2,22,7,50,0,2,2,Tulsa,/cfb/boxscores/2020-12-19-cincinnati.html
9.0,2020-12-31,N,Mississippi State*,L (26-28),26,46,56.5,347,1,40,137,3.4,2,86,484,5.6,18,8,1,27,7,66,0,2,2,Tulsa,/cfb/boxscores/2020-12-31-mississippi-state.html
1.0,2020-09-03,,Central Arkansas,W (45-35),24,34,70.6,226,3,49,233,4.8,3,83,459,5.5,16,10,3,29,8,83,2,1,3,UAB,/cfb/boxscores/2020-09-03-alabama-birmingham.html
2.0,2020-09-10,@,Miami (FL),L (14-31),19,35,54.3,205,1,26,80,3.1,1,61,285,4.7,9,4,1,14,11,75,0,0,0,UAB,/cfb/boxscores/2020-09-10-miami-fl.html
3.0,2020-09-24,@,South Alabama,W (42-10),18,28,64.3,319,2,42,190,4.5,4,70,509,7.3,11,10,1,22,11,122,1,0,1,UAB,/cfb/boxscores/2020-09-24-south-alabama.html
4.0,2020-10-03,,UTSA,W (21-13),18,30,60.0,195,3,37,214,5.8,0,67,409,6.1,9,9,3,21,6,72,1,3,4,UAB,/cfb/boxscores/2020-10-03-alabama-birmingham.html
5.0,2020-10-17,,Western Kentucky,W (37-14),15,31,48.4,141,1,35,217,6.2,2,66,358,5.4,7,8,2,17,9,82,1,1,2,UAB,/cfb/boxscores/2020-10-17-alabama-birmingham.html
6.0,2020-10-23,,Louisiana,L (20-24),10,23,43.5,110,0,40,175,4.4,2,63,285,4.5,7,9,1,17,10,90,0,2,2,UAB,/cfb/boxscores/2020-10-23-alabama-birmingham.html
7.0,2020-10-31,@,Louisiana Tech,L (34-37),11,23,47.8,147,0,51,338,6.6,4,74,485,6.6,6,13,1,20,12,105,1,2,3,UAB,/cfb/boxscores/2020-10-31-louisiana-tech.html
8.0,2020-12-12,@,Rice,W (21-16),9,18,50.0,217,2,34,137,4.0,1,52,354,6.8,6,6,1,13,9,81,0,0,0,UAB,/cfb/boxscores/2020-12-12-rice.html
9.0,2020-12-18,@,Marshall,W (22-13),12,22,54.5,252,2,52,216,4.2,0,74,468,6.3,10,10,1,21,6,50,1,0,1,UAB,/cfb/boxscores/2020-12-18-marshall.html
1.0,2020-09-19,@,Georgia Tech,W (49-21),27,41,65.9,417,4,51,243,4.8,3,92,660,7.2,15,14,2,31,8,51,1,1,2,UCF,/cfb/boxscores/2020-09-19-georgia-tech.html
2.0,2020-09-26,@,East Carolina,W (51-28),32,47,68.1,408,4,40,224,5.6,2,87,632,7.3,18,10,1,29,19,139,0,0,0,UCF,/cfb/boxscores/2020-09-26-east-carolina.html
3.0,2020-10-03,,Tulsa,L (26-34),28,51,54.9,330,1,34,125,3.7,2,85,455,5.4,13,7,3,23,18,124,2,1,3,UCF,/cfb/boxscores/2020-10-03-central-florida.html
4.0,2020-10-17,@,Memphis,L (49-50),35,49,71.4,601,5,47,197,4.2,2,96,798,8.3,22,12,0,34,10,96,1,0,1,UCF,/cfb/boxscores/2020-10-17-memphis.html
5.0,2020-10-24,,Tulane,W (51-34),26,40,65.0,422,5,59,267,4.5,2,99,689,7.0,17,19,0,36,4,20,0,0,0,UCF,/cfb/boxscores/2020-10-24-central-florida.html
6.0,2020-10-31,@,Houston,W (44-21),19,33,57.6,328,2,51,353,6.9,3,84,681,8.1,13,18,1,32,8,70,1,0,1,UCF,/cfb/boxscores/2020-10-31-houston.html
7.0,2020-11-14,,Temple,W (38-13),13,24,54.2,272,2,39,147,3.8,3,63,419,6.7,9,10,0,19,6,49,1,0,1,UCF,/cfb/boxscores/2020-11-14-central-florida.html
8.0,2020-11-21,,Cincinnati,L (33-36),26,49,53.1,243,3,35,116,3.3,1,84,359,4.3,11,8,4,23,5,65,0,1,1,UCF,/cfb/boxscores/2020-11-21-central-florida.html
9.0,2020-11-27,@,South Florida,W (58-46),22,36,61.1,336,4,45,241,5.4,4,81,577,7.1,12,13,3,28,7,80,0,1,1,UCF,/cfb/boxscores/2020-11-27-south-florida.html
10.0,2020-12-22,N,Brigham Young*,L (23-49),21,45,46.7,217,2,43,194,4.5,1,88,411,4.7,14,12,2,28,7,54,0,0,0,UCF,/cfb/boxscores/2020-12-22-brigham-young.html
1.0,2020-11-07,@,Colorado,L (42-48),20,40,50.0,303,4,24,180,7.5,2,64,483,7.5,13,5,5,23,9,69,3,1,4,UCLA,/cfb/boxscores/2020-11-07-colorado.html
2.0,2020-11-15,,California,W (34-10),14,26,53.8,196,3,54,244,4.5,2,80,440,5.5,8,14,1,23,6,50,0,1,1,UCLA,/cfb/boxscores/2020-11-15-ucla.html
3.0,2020-11-21,@,Oregon,L (35-38),19,31,61.3,195,1,51,267,5.2,3,82,462,5.6,10,16,1,27,8,60,2,2,4,UCLA,/cfb/boxscores/2020-11-21-oregon.html
4.0,2020-11-28,,Arizona,W (27-10),12,20,60.0,129,1,56,281,5.0,2,76,410,5.4,5,17,1,23,6,43,0,0,0,UCLA,/cfb/boxscores/2020-11-28-ucla.html
5.0,2020-12-05,@,Arizona State,W (25-18),18,24,75.0,192,1,39,171,4.4,2,63,363,5.8,8,10,4,22,5,37,0,0,0,UCLA,/cfb/boxscores/2020-12-05-arizona-state.html
6.0,2020-12-12,,Southern California,L (38-43),30,36,83.3,364,4,43,185,4.3,1,79,549,6.9,15,11,1,27,6,45,1,2,3,UCLA,/cfb/boxscores/2020-12-12-ucla.html
7.0,2020-12-19,,Stanford,L (47-48),17,23,73.9,192,4,51,291,5.7,1,74,483,6.5,9,17,1,27,8,70,1,0,1,UCLA,/cfb/boxscores/2020-12-19-ucla.html
1.0,2020-11-07,,Arizona State,W (28-27),40,55,72.7,381,2,40,175,4.4,2,95,556,5.9,16,12,0,28,5,59,3,1,4,USC,/cfb/boxscores/2020-11-07-southern-california.html
2.0,2020-11-14,@,Arizona,W (34-30),30,43,69.8,325,1,32,173,5.4,3,75,498,6.6,15,7,4,26,11,110,0,0,0,USC,/cfb/boxscores/2020-11-14-arizona.html
3.0,2020-11-21,@,Utah,W (33-17),24,35,68.6,264,2,31,93,3.0,1,66,357,5.4,12,5,0,17,5,49,1,1,2,USC,/cfb/boxscores/2020-11-21-utah.html
4.0,2020-12-06,,Washington State,W (38-13),26,33,78.8,282,5,20,5,0.3,0,53,287,5.4,15,0,0,15,5,50,0,0,0,USC,/cfb/boxscores/2020-12-06-southern-california.html
5.0,2020-12-12,@,UCLA,W (43-38),30,47,63.8,344,5,33,100,3.0,1,80,444,5.6,13,9,2,24,5,60,0,2,2,USC,/cfb/boxscores/2020-12-12-ucla.html
6.0,2020-12-18,,Oregon,L (24-31),28,52,53.8,320,2,28,38,1.4,1,80,358,4.5,17,4,4,25,9,98,0,3,3,USC,/cfb/boxscores/2020-12-18-southern-california.html
1.0,2020-11-21,,Southern California,L (17-33),19,34,55.9,216,1,28,111,4.0,0,62,327,5.3,10,6,1,17,6,52,2,3,5,Utah,/cfb/boxscores/2020-11-21-utah.html
2.0,2020-11-28,@,Washington,L (21-24),16,23,69.6,144,1,42,215,5.1,2,65,359,5.5,8,10,1,19,2,25,2,2,4,Utah,/cfb/boxscores/2020-11-28-washington.html
3.0,2020-12-05,,Oregon State,W (30-24),18,27,66.7,174,1,44,229,5.2,1,71,403,5.7,8,13,0,21,11,96,0,0,0,Utah,/cfb/boxscores/2020-12-05-utah.html
4.0,2020-12-12,@,Colorado,W (38-21),20,32,62.5,240,2,40,192,4.8,2,72,432,6.0,12,9,1,22,0,0,0,1,1,Utah,/cfb/boxscores/2020-12-12-colorado.html
5.0,2020-12-19,,Washington State,W (45-28),22,40,55.0,305,1,37,223,6.0,4,77,528,6.9,11,10,2,23,7,65,2,1,3,Utah,/cfb/boxscores/2020-12-19-utah.html
1.0,2020-10-24,@,Boise State,L (13-42),14,27,51.9,92,0,43,111,2.6,2,70,203,2.9,6,6,0,12,3,20,0,1,1,Utah State,/cfb/boxscores/2020-10-24-boise-state.html
2.0,2020-10-31,,San Diego State,L (7-38),18,31,58.1,112,1,25,103,4.1,0,56,215,3.8,2,7,2,11,3,32,1,2,3,Utah State,/cfb/boxscores/2020-10-31-utah-state.html
3.0,2020-11-05,@,Nevada,L (9-34),16,34,47.1,101,1,25,109,4.4,0,59,210,3.6,5,4,2,11,5,52,0,0,0,Utah State,/cfb/boxscores/2020-11-05-nevada.html
4.0,2020-11-14,,Fresno State,L (16-35),9,24,37.5,144,0,35,199,5.7,1,59,343,5.8,4,7,1,12,6,40,2,0,2,Utah State,/cfb/boxscores/2020-11-14-utah-state.html
5.0,2020-11-26,,New Mexico,W (41-27),15,22,68.2,243,3,38,209,5.5,1,60,452,7.5,9,10,3,22,9,75,2,0,2,Utah State,/cfb/boxscores/2020-11-26-utah-state.html
6.0,2020-12-03,,Air Force,L (7-35),17,32,53.1,123,1,26,109,4.2,0,58,232,4.0,8,4,2,14,6,65,0,2,2,Utah State,/cfb/boxscores/2020-12-03-utah-state.html
1.0,2020-09-05,,Stephen F. Austin,W (24-14),17,28,60.7,212,1,37,152,4.1,2,65,364,5.6,10,7,2,19,4,40,1,1,2,UTEP,/cfb/boxscores/2020-09-05-texas-el-paso.html
2.0,2020-09-12,@,Texas,L (3-59),19,39,48.7,190,0,33,43,1.3,0,72,233,3.2,8,4,2,14,7,30,0,1,1,UTEP,/cfb/boxscores/2020-09-12-texas.html
3.0,2020-09-19,,Abilene Christian,W (17-13),15,25,60.0,195,0,34,98,2.9,2,59,293,5.0,7,7,3,17,4,58,0,0,0,UTEP,/cfb/boxscores/2020-09-19-texas-el-paso.html
4.0,2020-09-26,@,Louisiana-Monroe,W (31-6),13,25,52.0,302,0,47,210,4.5,4,72,512,7.1,11,10,0,21,7,60,1,0,1,UTEP,/cfb/boxscores/2020-09-26-louisiana-monroe.html
5.0,2020-10-10,@,Louisiana Tech,L (17-21),18,39,46.2,206,1,27,60,2.2,0,66,266,4.0,9,4,1,14,12,128,1,1,2,UTEP,/cfb/boxscores/2020-10-10-louisiana-tech.html
6.0,2020-10-24,@,Charlotte,L (28-38),19,35,54.3,204,2,38,170,4.5,2,73,374,5.1,11,9,4,24,5,40,1,2,3,UTEP,/cfb/boxscores/2020-10-24-charlotte.html
7.0,2020-11-14,@,UTSA,L (21-52),15,22,68.2,169,1,28,77,2.8,2,50,246,4.9,7,4,2,13,6,56,2,0,2,UTEP,/cfb/boxscores/2020-11-14-texas-san-antonio.html
8.0,2020-12-11,,North Texas,L (43-45),10,26,38.5,196,2,56,301,5.4,4,82,497,6.1,8,16,3,27,12,93,0,4,4,UTEP,/cfb/boxscores/2020-12-11-texas-el-paso.html
1.0,2020-09-12,@,Texas State,W (51-48),23,31,74.2,169,1,51,330,6.5,4,82,499,6.1,8,14,2,24,11,126,0,0,0,UTSA,/cfb/boxscores/2020-09-12-texas-state.html
2.0,2020-09-19,,Stephen F. Austin,W (24-10),23,36,63.9,269,1,48,229,4.8,2,84,498,5.9,12,11,2,25,7,65,1,1,2,UTSA,/cfb/boxscores/2020-09-19-texas-san-antonio.html
3.0,2020-09-25,,Middle Tennessee State,W (37-35),23,43,53.5,303,2,28,88,3.1,2,71,391,5.5,12,2,2,16,3,29,0,1,1,UTSA,/cfb/boxscores/2020-09-25-texas-san-antonio.html
4.0,2020-10-03,@,Alabama-Birmingham,L (13-21),9,25,36.0,90,0,36,190,5.3,1,61,280,4.6,6,7,4,17,10,98,0,1,1,UTSA,/cfb/boxscores/2020-10-03-alabama-birmingham.html
5.0,2020-10-10,@,Brigham Young,L (20-27),24,33,72.7,287,2,28,72,2.6,0,61,359,5.9,12,4,1,17,9,79,0,1,1,UTSA,/cfb/boxscores/2020-10-10-brigham-young.html
6.0,2020-10-17,,Army,L (16-28),19,39,48.7,186,2,32,197,6.2,0,71,383,5.4,11,9,4,24,9,85,0,0,0,UTSA,/cfb/boxscores/2020-10-17-texas-san-antonio.html
7.0,2020-10-24,,Louisiana Tech,W (27-26),19,34,55.9,197,0,53,188,3.5,3,87,385,4.4,10,11,4,25,6,44,0,2,2,UTSA,/cfb/boxscores/2020-10-24-texas-san-antonio.html
8.0,2020-10-31,@,Florida Atlantic,L (3-24),14,35,40.0,126,0,37,104,2.8,0,72,230,3.2,7,9,0,16,5,46,0,0,0,UTSA,/cfb/boxscores/2020-10-31-florida-atlantic.html
9.0,2020-11-14,,UTEP,W (52-21),22,28,78.6,312,3,48,288,6.0,4,76,600,7.9,14,12,3,29,6,43,2,0,2,UTSA,/cfb/boxscores/2020-11-14-texas-san-antonio.html
10.0,2020-11-21,@,Southern Mississippi,W (23-20),12,19,63.2,71,1,47,233,5.0,2,66,304,4.6,4,12,0,16,5,51,0,1,1,UTSA,/cfb/boxscores/2020-11-21-southern-mississippi.html
11.0,2020-11-28,,North Texas,W (49-17),21,26,80.8,181,2,44,443,10.1,5,70,624,8.9,9,17,0,26,5,40,0,0,0,UTSA,/cfb/boxscores/2020-11-28-texas-san-antonio.html
12.0,2020-12-26,N,Louisiana*,L (24-31),13,21,61.9,208,2,44,223,5.1,1,65,431,6.6,10,13,4,27,7,66,1,1,2,UTSA,/cfb/boxscores/2020-12-26-texas-san-antonio.html
1.0,2020-09-26,@,Texas A&M,L (12-17),20,29,69.0,150,1,38,105,2.8,0,67,255,3.8,9,6,2,17,3,35,0,2,2,Vanderbilt,/cfb/boxscores/2020-09-26-texas-am.html
2.0,2020-10-03,,Louisiana State,L (7-41),11,25,44.0,113,1,43,153,3.6,0,68,266,3.9,5,11,1,17,5,24,0,2,2,Vanderbilt,/cfb/boxscores/2020-10-03-vanderbilt.html
3.0,2020-10-10,,South Carolina,L (7-41),18,27,66.7,173,1,33,76,2.3,0,60,249,4.2,8,7,0,15,2,21,1,1,2,Vanderbilt,/cfb/boxscores/2020-10-10-vanderbilt.html
4.0,2020-10-31,,Mississippi,L (21-54),31,41,75.6,319,2,34,102,3.0,1,75,421,5.6,17,4,3,24,6,50,2,1,3,Vanderbilt,/cfb/boxscores/2020-10-31-vanderbilt.html
5.0,2020-11-07,@,Mississippi State,L (17-24),31,46,67.4,336,1,36,142,3.9,1,82,478,5.8,16,9,5,30,6,52,2,3,5,Vanderbilt,/cfb/boxscores/2020-11-07-mississippi-state.html
6.0,2020-11-14,@,Kentucky,L (35-38),22,35,62.9,227,3,45,180,4.0,2,80,407,5.1,12,13,4,29,6,50,0,0,0,Vanderbilt,/cfb/boxscores/2020-11-14-kentucky.html
7.0,2020-11-21,,Florida,L (17-38),22,34,64.7,319,2,34,87,2.6,0,68,406,6.0,14,5,2,21,4,30,0,1,1,Vanderbilt,/cfb/boxscores/2020-11-21-vanderbilt.html
8.0,2020-11-28,@,Missouri,L (0-41),15,25,60.0,103,0,35,93,2.7,0,60,196,3.3,7,6,0,13,3,21,1,0,1,Vanderbilt,/cfb/boxscores/2020-11-28-missouri.html
9.0,2020-12-12,,Tennessee,L (17-42),22,39,56.4,239,2,31,53,1.7,0,70,292,4.2,8,7,1,16,7,60,0,1,1,Vanderbilt,/cfb/boxscores/2020-12-12-vanderbilt.html
1.0,2020-09-26,,Duke,W (38-20),25,47,53.2,262,2,37,188,5.1,3,84,450,5.4,14,10,1,25,5,35,1,2,3,Virginia,/cfb/boxscores/2020-09-26-virginia.html
2.0,2020-10-03,@,Clemson,L (23-41),24,43,55.8,270,3,38,147,3.9,0,81,417,5.1,13,9,3,25,1,15,0,2,2,Virginia,/cfb/boxscores/2020-10-03-clemson.html
3.0,2020-10-10,,North Carolina State,L (21-38),37,64,57.8,323,3,29,82,2.8,0,93,405,4.4,19,3,4,26,6,56,1,3,4,Virginia,/cfb/boxscores/2020-10-10-virginia.html
4.0,2020-10-17,@,Wake Forest,L (23-40),25,45,55.6,202,0,38,218,5.7,2,83,420,5.1,9,13,5,27,5,52,1,2,3,Virginia,/cfb/boxscores/2020-10-17-wake-forest.html
5.0,2020-10-24,@,Miami (FL),L (14-19),16,32,50.0,181,2,35,185,5.3,0,67,366,5.5,6,11,1,18,6,48,1,0,1,Virginia,/cfb/boxscores/2020-10-24-miami-fl.html
6.0,2020-10-31,,North Carolina,W (44-41),12,22,54.5,208,3,51,210,4.1,3,73,418,5.7,9,15,4,28,5,38,0,1,1,Virginia,/cfb/boxscores/2020-10-31-virginia.html
7.0,2020-11-14,,Louisville,W (31-17),15,23,65.2,203,1,42,165,3.9,2,65,368,5.7,8,10,3,21,3,25,1,1,2,Virginia,/cfb/boxscores/2020-11-14-virginia.html
8.0,2020-11-21,,Abilene Christian,W (55-15),22,29,75.9,403,5,33,115,3.5,2,62,518,8.4,14,7,2,23,6,53,0,0,0,Virginia,/cfb/boxscores/2020-11-21-virginia.html
9.0,2020-12-05,,Boston College,W (43-32),19,27,70.4,287,1,42,262,6.2,4,69,549,8.0,9,13,2,24,10,95,0,1,1,Virginia,/cfb/boxscores/2020-12-05-virginia.html
10.0,2020-12-12,@,Virginia Tech,L (15-33),26,47,55.3,267,2,21,55,2.6,0,68,322,4.7,15,4,0,19,5,41,0,2,2,Virginia,/cfb/boxscores/2020-12-12-virginia-tech.html
1.0,2020-09-26,,North Carolina State,W (45-24),11,17,64.7,181,2,41,314,7.7,3,58,495,8.5,8,13,1,22,5,40,0,0,0,Virginia Tech,/cfb/boxscores/2020-09-26-virginia-tech.html
2.0,2020-10-03,@,Duke,W (38-31),9,25,36.0,163,1,50,324,6.5,4,75,487,6.5,7,16,2,25,3,20,2,1,3,Virginia Tech,/cfb/boxscores/2020-10-03-duke.html
3.0,2020-10-10,@,North Carolina,L (45-56),15,29,51.7,235,2,48,260,5.4,4,77,495,6.4,8,15,2,25,4,26,0,0,0,Virginia Tech,/cfb/boxscores/2020-10-10-north-carolina.html
4.0,2020-10-17,,Boston College,W (40-14),11,15,73.3,111,1,41,350,8.5,4,56,461,8.2,6,16,1,23,7,63,0,0,0,Virginia Tech,/cfb/boxscores/2020-10-17-virginia-tech.html
5.0,2020-10-24,@,Wake Forest,L (16-23),17,35,48.6,223,1,43,210,4.9,0,78,433,5.6,9,15,4,28,10,112,0,3,3,Virginia Tech,/cfb/boxscores/2020-10-24-wake-forest.html
6.0,2020-10-31,@,Louisville,W (42-35),10,10,100.0,183,0,51,283,5.5,5,61,466,7.6,8,12,1,21,7,71,0,0,0,Virginia Tech,/cfb/boxscores/2020-10-31-louisville.html
7.0,2020-11-07,,Liberty,L (35-38),20,27,74.1,217,3,31,201,6.5,1,58,418,7.2,12,10,2,24,5,45,1,0,1,Virginia Tech,/cfb/boxscores/2020-11-07-virginia-tech.html
8.0,2020-11-14,,Miami (FL),L (24-25),19,30,63.3,202,0,41,160,3.9,3,71,362,5.1,9,10,4,23,2,10,0,1,1,Virginia Tech,/cfb/boxscores/2020-11-14-virginia-tech.html
9.0,2020-11-21,@,Pittsburgh,L (14-47),16,26,61.5,278,2,37,156,4.2,0,63,434,6.9,9,8,0,17,6,55,1,1,2,Virginia Tech,/cfb/boxscores/2020-11-21-pittsburgh.html
10.0,2020-12-05,,Clemson,L (10-45),15,19,78.9,202,0,45,131,2.9,1,64,333,5.2,8,9,1,18,2,25,3,0,3,Virginia Tech,/cfb/boxscores/2020-12-05-virginia-tech.html
11.0,2020-12-12,,Virginia,W (33-15),15,22,68.2,212,1,45,252,5.6,2,67,464,6.9,9,10,1,20,7,50,1,0,1,Virginia Tech,/cfb/boxscores/2020-12-12-virginia-tech.html
1.0,2020-09-12,,Clemson,L (13-37),19,38,50.0,293,1,34,37,1.1,0,72,330,4.6,8,4,3,15,1,6,0,0,0,Wake Forest,/cfb/boxscores/2020-09-12-wake-forest.html
2.0,2020-09-19,@,North Carolina State,L (42-45),23,36,63.9,236,1,49,149,3.0,4,85,385,4.5,14,14,4,32,3,15,1,0,1,Wake Forest,/cfb/boxscores/2020-09-19-north-carolina-state.html
3.0,2020-10-02,,Campbell,W (66-14),16,21,76.2,275,1,45,299,6.6,6,66,574,8.7,11,18,0,29,5,40,0,0,0,Wake Forest,/cfb/boxscores/2020-10-02-wake-forest.html
4.0,2020-10-17,,Virginia,W (40-23),16,27,59.3,309,1,42,174,4.1,3,69,483,7.0,12,6,0,18,12,119,0,0,0,Wake Forest,/cfb/boxscores/2020-10-17-wake-forest.html
5.0,2020-10-24,,Virginia Tech,W (23-16),12,17,70.6,110,0,49,206,4.2,2,66,316,4.8,5,8,4,17,6,79,0,0,0,Wake Forest,/cfb/boxscores/2020-10-24-wake-forest.html
6.0,2020-10-31,@,Syracuse,W (38-14),19,33,57.6,250,1,49,188,3.8,3,82,438,5.3,12,10,3,25,7,57,0,0,0,Wake Forest,/cfb/boxscores/2020-10-31-syracuse.html
7.0,2020-11-14,@,North Carolina,L (53-59),29,45,64.4,429,4,46,177,3.8,3,91,606,6.7,16,12,2,30,4,20,0,0,0,Wake Forest,/cfb/boxscores/2020-11-14-north-carolina.html
8.0,2020-12-12,@,Louisville,L (21-45),17,41,41.5,224,2,31,127,4.1,0,72,351,4.9,11,6,0,17,5,39,1,1,2,Wake Forest,/cfb/boxscores/2020-12-12-louisville.html
9.0,2020-12-30,N,Wisconsin*,L (28-42),24,52,46.2,407,3,35,111,3.2,1,87,518,6.0,20,4,3,27,5,26,0,4,4,Wake Forest,/cfb/boxscores/2020-12-30-wisconsin.html
1.0,2020-11-14,,Oregon State,W (27-21),14,24,58.3,141,0,51,267,5.2,3,75,408,5.4,5,16,3,24,5,35,0,0,0,Washington,/cfb/boxscores/2020-11-14-washington.html
2.0,2020-11-21,,Arizona,W (44-27),16,26,61.5,239,2,45,233,5.2,4,71,472,6.6,10,13,1,24,6,46,0,0,0,Washington,/cfb/boxscores/2020-11-21-washington.html
3.0,2020-11-28,,Utah,W (24-21),23,38,60.5,272,2,26,88,3.4,1,64,360,5.6,15,4,1,20,6,51,0,3,3,Washington,/cfb/boxscores/2020-11-28-washington.html
4.0,2020-12-05,,Stanford,L (26-31),15,23,65.2,254,0,34,117,3.4,3,57,371,6.5,10,8,1,19,4,30,0,0,0,Washington,/cfb/boxscores/2020-12-05-washington.html
1.0,2020-11-07,@,Oregon State,W (38-28),18,33,54.5,227,2,30,229,7.6,3,63,456,7.2,11,9,1,21,5,44,0,1,1,Washington State,/cfb/boxscores/2020-11-07-oregon-state.html
2.0,2020-11-14,,Oregon,L (29-43),25,39,64.1,321,2,27,100,3.7,1,66,421,6.4,14,4,2,20,4,40,0,0,0,Washington State,/cfb/boxscores/2020-11-14-washington-state.html
3.0,2020-12-06,@,Southern California,L (13-38),26,39,66.7,190,1,27,73,2.7,1,66,263,4.0,10,7,3,20,3,15,1,2,3,Washington State,/cfb/boxscores/2020-12-06-southern-california.html
4.0,2020-12-19,@,Utah,L (28-45),25,41,61.0,281,1,26,115,4.4,3,67,396,5.9,12,4,1,17,9,88,3,1,4,Washington State,/cfb/boxscores/2020-12-19-utah.html
1.0,2020-09-12,,Eastern Kentucky,W (56-10),25,35,71.4,295,3,51,329,6.5,5,86,624,7.3,11,17,3,31,8,85,0,0,0,West Virginia,/cfb/boxscores/2020-09-12-west-virginia.html
2.0,2020-09-26,@,Oklahoma State,L (13-27),20,37,54.1,285,1,42,68,1.6,0,79,353,4.5,12,7,3,22,12,106,1,0,1,West Virginia,/cfb/boxscores/2020-09-26-oklahoma-state.html
3.0,2020-10-03,,Baylor,W (27-21),30,42,71.4,211,1,39,134,3.4,3,81,345,4.3,10,7,1,18,12,102,2,2,4,West Virginia,/cfb/boxscores/2020-10-03-west-virginia.html
4.0,2020-10-17,,Kansas,W (38-17),26,44,59.1,318,3,38,226,5.9,2,82,544,6.6,15,10,4,29,8,76,1,1,2,West Virginia,/cfb/boxscores/2020-10-17-west-virginia.html
5.0,2020-10-24,@,Texas Tech,L (27-34),32,50,64.0,347,1,29,91,3.1,2,79,438,5.5,14,7,1,22,7,69,1,0,1,West Virginia,/cfb/boxscores/2020-10-24-texas-tech.html
6.0,2020-10-31,,Kansas State,W (37-10),22,34,64.7,301,2,44,184,4.2,1,78,485,6.2,14,7,2,23,5,50,1,0,1,West Virginia,/cfb/boxscores/2020-10-31-west-virginia.html
7.0,2020-11-07,@,Texas,L (13-17),35,50,70.0,317,0,26,43,1.7,1,76,360,4.7,15,4,2,21,6,50,0,0,0,West Virginia,/cfb/boxscores/2020-11-07-texas.html
8.0,2020-11-14,,TCU,W (24-6),19,26,73.1,212,2,37,180,4.9,1,63,392,6.2,11,6,1,18,10,85,0,0,0,West Virginia,/cfb/boxscores/2020-11-14-west-virginia.html
9.0,2020-12-05,@,Iowa State,L (6-42),21,41,51.2,209,0,25,54,2.2,0,66,263,4.0,9,6,1,16,7,65,0,0,0,West Virginia,/cfb/boxscores/2020-12-05-iowa-state.html
10.0,2020-12-31,N,Army*,W (24-21),23,42,54.8,280,3,27,42,1.6,0,69,322,4.7,14,3,2,19,7,53,1,1,2,West Virginia,/cfb/boxscores/2020-12-31-army.html
1.0,2020-09-12,@,Louisville,L (21-35),10,23,43.5,129,1,35,119,3.4,2,58,248,4.3,3,8,1,12,4,23,1,0,1,Western Kentucky,/cfb/boxscores/2020-09-12-louisville.html
2.0,2020-09-19,,Liberty,L (24-30),18,25,72.0,193,3,28,98,3.5,0,53,291,5.5,9,6,3,18,2,19,0,0,0,Western Kentucky,/cfb/boxscores/2020-09-19-western-kentucky.html
3.0,2020-10-03,@,Middle Tennessee State,W (20-17),21,36,58.3,188,2,35,146,4.2,0,71,334,4.7,10,11,0,21,5,55,1,0,1,Western Kentucky,/cfb/boxscores/2020-10-03-middle-tennessee-state.html
4.0,2020-10-10,,Marshall,L (14-38),21,39,53.8,209,1,25,85,3.4,1,64,294,4.6,11,3,1,15,0,0,3,0,3,Western Kentucky,/cfb/boxscores/2020-10-10-western-kentucky.html
5.0,2020-10-17,@,Alabama-Birmingham,L (14-37),16,35,45.7,162,2,32,88,2.8,0,67,250,3.7,6,8,1,15,4,39,2,2,4,Western Kentucky,/cfb/boxscores/2020-10-17-alabama-birmingham.html
6.0,2020-10-24,,Chattanooga,W (13-10),16,25,64.0,132,1,33,122,3.7,0,58,254,4.4,7,6,1,14,3,25,2,0,2,Western Kentucky,/cfb/boxscores/2020-10-24-western-kentucky.html
7.0,2020-10-31,@,Brigham Young,L (10-41),19,31,61.3,106,1,34,156,4.6,0,65,262,4.0,6,10,1,17,10,96,1,0,1,Western Kentucky,/cfb/boxscores/2020-10-31-brigham-young.html
8.0,2020-11-07,@,Florida Atlantic,L (6-10),19,40,47.5,163,0,27,94,3.5,0,67,257,3.8,7,9,0,16,6,50,0,0,0,Western Kentucky,/cfb/boxscores/2020-11-07-florida-atlantic.html
9.0,2020-11-14,,Southern Mississippi,W (10-7),19,30,63.3,183,0,40,121,3.0,1,70,304,4.3,8,10,1,19,3,25,0,0,0,Western Kentucky,/cfb/boxscores/2020-11-14-western-kentucky.html
10.0,2020-11-21,,Florida International,W (38-21),14,25,56.0,121,0,34,157,4.6,3,59,278,4.7,7,6,0,13,4,40,0,0,0,Western Kentucky,/cfb/boxscores/2020-11-21-western-kentucky.html
11.0,2020-12-06,@,Charlotte,W (37-19),18,27,66.7,218,1,37,218,5.9,1,64,436,6.8,8,12,1,21,4,28,0,0,0,Western Kentucky,/cfb/boxscores/2020-12-06-charlotte.html
12.0,2020-12-26,N,Georgia State*,L (21-39),17,33,51.5,180,0,26,104,4.0,3,59,284,4.8,7,7,0,14,9,81,1,2,3,Western Kentucky,/cfb/boxscores/2020-12-26-georgia-state.html
1.0,2020-11-04,@,Akron,W (58-13),13,19,68.4,266,3,39,218,5.6,4,58,484,8.3,9,11,1,21,6,65,0,0,0,Western Michigan,/cfb/boxscores/2020-11-04-akron.html
2.0,2020-11-11,,Toledo,W (41-38),20,29,69.0,284,3,28,153,5.5,3,57,437,7.7,14,6,4,24,9,102,0,0,0,Western Michigan,/cfb/boxscores/2020-11-11-western-michigan.html
3.0,2020-11-18,@,Central Michigan,W (52-44),12,20,60.0,382,5,55,246,4.5,2,75,628,8.4,10,11,4,25,8,58,0,1,1,Western Michigan,/cfb/boxscores/2020-11-18-central-michigan.html
4.0,2020-11-28,,Northern Illinois,W (30-27),12,24,50.0,210,1,25,115,4.6,2,49,325,6.6,9,5,1,15,7,44,0,0,0,Western Michigan,/cfb/boxscores/2020-11-28-western-michigan.html
5.0,2020-12-05,,Eastern Michigan,L (42-53),18,26,69.2,288,4,38,225,5.9,2,64,513,8.0,8,14,1,23,13,93,3,0,3,Western Michigan,/cfb/boxscores/2020-12-05-western-michigan.html
6.0,2020-12-12,@,Ball State,L (27-30),24,38,63.2,273,2,51,218,4.3,1,89,491,5.5,16,15,3,34,4,34,1,1,2,Western Michigan,/cfb/boxscores/2020-12-12-ball-state.html
1.0,2020-10-23,,Illinois,W (45-7),20,21,95.2,248,5,54,182,3.4,1,75,430,5.7,9,11,3,23,3,15,1,0,1,Wisconsin,/cfb/boxscores/2020-10-23-wisconsin.html
2.0,2020-11-14,@,Michigan,W (49-11),12,22,54.5,127,2,51,341,6.7,5,73,468,6.4,8,15,3,26,1,5,0,0,0,Wisconsin,/cfb/boxscores/2020-11-14-michigan.html
3.0,2020-11-21,@,Northwestern,L (7-17),23,42,54.8,230,1,40,136,3.4,0,82,366,4.5,10,11,0,21,8,69,2,3,5,Wisconsin,/cfb/boxscores/2020-11-21-northwestern.html
4.0,2020-12-05,,Indiana,L (6-14),20,34,58.8,202,0,35,140,4.0,0,69,342,5.0,10,8,1,19,8,81,1,1,2,Wisconsin,/cfb/boxscores/2020-12-05-wisconsin.html
5.0,2020-12-12,@,Iowa,L (7-28),20,38,52.6,169,0,33,56,1.7,1,71,225,3.2,7,4,0,11,5,40,1,1,2,Wisconsin,/cfb/boxscores/2020-12-12-iowa.html
6.0,2020-12-19,,Minnesota,W (20-17),16,25,64.0,147,1,36,175,4.9,1,61,322,5.3,7,10,1,18,5,47,0,1,1,Wisconsin,/cfb/boxscores/2020-12-19-wisconsin.html
7.0,2020-12-30,N,Wake Forest*,W (42-28),13,20,65.0,144,1,44,122,2.8,5,64,266,4.2,5,11,3,19,6,39,0,1,1,Wisconsin,/cfb/boxscores/2020-12-30-wisconsin.html
1.0,2020-10-24,@,Nevada,L (34-37),17,32,53.1,233,1,35,128,3.7,2,67,361,5.4,8,8,3,19,2,6,0,1,1,Wyoming,/cfb/boxscores/2020-10-24-nevada.html
2.0,2020-10-30,,Hawaii,W (31-7),9,18,50.0,112,0,59,281,4.8,4,77,393,5.1,5,18,1,24,5,47,1,0,1,Wyoming,/cfb/boxscores/2020-10-30-wyoming.html
3.0,2020-11-05,@,Colorado State,L (24-34),19,32,59.4,321,0,48,144,3.0,3,80,465,5.8,13,9,1,23,8,83,2,1,3,Wyoming,/cfb/boxscores/2020-11-05-colorado-state.html
4.0,2020-11-27,@,Nevada-Las Vegas,W (45-14),8,14,57.1,99,0,57,399,7.0,6,71,498,7.0,5,19,0,24,6,45,0,0,0,Wyoming,/cfb/boxscores/2020-11-27-nevada-las-vegas.html
5.0,2020-12-05,@,New Mexico,L (16-17),5,17,29.4,91,0,38,283,7.4,1,55,374,6.8,2,9,1,12,2,20,1,2,3,Wyoming,/cfb/boxscores/2020-12-05-new-mexico.html
6.0,2020-12-12,,Boise State,L (9-17),4,21,19.0,64,0,38,82,2.2,0,59,146,2.5,3,5,1,9,7,58,0,1,1,Wyoming,/cfb/boxscores/2020-12-12-wyoming.html
